אוביפֿראַט	ו ב י פֿ ר אַ ט
אוגערקעלעך	ו ג ע ר ק ע ל ע כ
אולעײלאָ	ו ל ע ײ ל אָ
אום	ו מ
אומ־	ו מ
אומבעראַכמאָנעס	ו מ ב ע ר אַ כ מ אָ נ ע ס
אומגליק	ו מ ג ל י ק
אומגליקלעכער	ו מ ג ל י ק ל ע כ ע ר
אומגליקן	ו מ ג ל י ק נ
אומגעדולדיקער	ו מ ג ע ד ו ל ד י ק ע ר
אומגעהױער	ו מ ג ע ה ױ ע ר
אומגעהױערס	ו מ ג ע ה ױ ע ר ס
אומגעקוקט	ו מ ג ע ק ו ק ט
אומגעריכט	ו מ ג ע ר י כ ט
אומגעװאָרפֿן	ו מ ג ע װ אָ ר פֿ נ
אומזיסט	ו מ ז י ס ט
אומיסטנע	ו מ י ס ט נ ע
אוממעגלעך	ו מ מ ע ג ל ע כ
אומעטום	ו מ ע ט ו מ
אומענער	ו מ ע נ ע ר
אומצײַטיקע	ו מ צ ײַ ט י ק ע
אומקוקן	ו מ ק ו ק נ
אומקערן	ו מ ק ע ר נ
אומשולדיקן	ו מ ש ו ל ד י ק נ
אומשולדיקער	ו מ ש ו ל ד י ק ע ר
אומאַן	ו מ אַ נ
און	ו נ
און־	ו נ
אונדז	ו נ ד ז
אונדזער	ו נ ד ז ע ר
אונדזערע	ו נ ד ז ע ר ע
אונטן	ו נ ט נ
אונטער	ו נ ט ע ר
אונטערגעבן	ו נ ט ע ר ג ע ב נ
אונטערגעגאַנגען	ו נ ט ע ר ג ע ג אַ נ ג ע נ
אונטערגעהאַקט	ו נ ט ע ר ג ע ה אַ ק ט
אונטערגעכאַפּט	ו נ ט ע ר ג ע כ אַ פּ ט
אונטערגעלײגט	ו נ ט ע ר ג ע ל ײ ג ט
אונטערגעצונדן	ו נ ט ע ר ג ע צ ו נ ד נ
אונטערגעשטופּט	ו נ ט ע ר ג ע ש ט ו פּ ט
אונטערגעשריבן	ו נ ט ע ר ג ע ש ר י ב נ
אונטערגעשפּרונגען	ו נ ט ע ר ג ע ש פּ ר ו נ ג ע נ
אונטערגײן	ו נ ט ע ר ג ײ נ
אונטערן	ו נ ט ע ר נ
אונטערצוהײצן	ו נ ט ע ר צ ו ה ײ צ נ
אונטערקוקן	ו נ ט ע ר ק ו ק נ
אונטערשטע	ו נ ט ע ר ש ט ע
אונטערשיד	ו נ ט ע ר ש י ד
אונטערשערן	ו נ ט ע ר ש ע ר נ
אוניװערסיטעט	ו נ י װ ע ר ס י ט ע ט
אוקאַז	ו ק אַ ז
אי	י
איבער	י ב ע ר
איבערבלײַבן	י ב ע ר ב ל ײַ ב נ
איבערבײַטן	י ב ע ר ב ײַ ט נ
איבערגעבליבן	י ב ע ר ג ע ב ל י ב נ
איבערגעבן	י ב ע ר ג ע ב נ
איבערגעבנדיק	י ב ע ר ג ע ב נ ד י ק
איבערגעבראָכן	י ב ע ר ג ע ב ר אָ כ נ
איבערגעגעבן	י ב ע ר ג ע ג ע ב נ
איבערגעגאַנגען	י ב ע ר ג ע ג אַ נ ג ע נ
איבערגעדעקט	י ב ע ר ג ע ד ע ק ט
איבערגעדרײט	י ב ע ר ג ע ד ר ײ ט
איבערגעהאַקט	י ב ע ר ג ע ה אַ ק ט
איבערגעיאָגט	י ב ע ר ג ע י אָ ג ט
איבערגעכאַזערט	י ב ע ר ג ע כ אַ ז ע ר ט
איבערגעלײגט	י ב ע ר ג ע ל ײ ג ט
איבערגעלײענט	י ב ע ר ג ע ל ײ ע נ ט
איבערגעלאָזט	י ב ע ר ג ע ל אָ ז ט
איבערגענומען	י ב ע ר ג ע נ ו מ ע נ
איבערגעצײלט	י ב ע ר ג ע צ ײ ל ט
איבערגעקוקט	י ב ע ר ג ע ק ו ק ט
איבערגעקלונגען	י ב ע ר ג ע ק ל ו נ ג ע נ
איבערגעקערט	י ב ע ר ג ע ק ע ר ט
איבערגערעכנט	י ב ע ר ג ע ר ע כ נ ט
איבערגעשראָקן	י ב ע ר ג ע ש ר אָ ק נ
איבערגעװינקט	י ב ע ר ג ע װ י נ ק ט
איבערגעפֿאָרן	י ב ע ר ג ע פֿ אָ ר נ
איבערהױפּט	י ב ע ר ה ױ פּ ט
איבעריק	י ב ע ר י ק
איבעריקנס	י ב ע ר י ק נ ס
איבעריקס	י ב ע ר י ק ס
איבעריקע	י ב ע ר י ק ע
איבערכאַזערן	י ב ע ר כ אַ ז ע ר נ
איבערלױפֿן	י ב ע ר ל ױ פֿ נ
איבערלײענען	י ב ע ר ל ײ ע נ ע נ
איבערלאָזן	י ב ע ר ל אָ ז נ
איבערמאַכן	י ב ע ר מ אַ כ נ
איבערמאָרגן	י ב ע ר מ אָ ר ג נ
איבערן	י ב ע ר נ
איבערנעמען	י ב ע ר נ ע מ ע נ
איבערצולאָזן	י ב ע ר צ ו ל אָ ז נ
איבערצונעכטיקן	י ב ע ר צ ו נ ע כ ט י ק נ
איבערצוצײלן	י ב ע ר צ ו צ ײ ל נ
איבערצײלן	י ב ע ר צ ײ ל נ
איבערציִער	י ב ע ר צ יִ ע ר
איבערצײַגט	י ב ע ר צ ײַ ג ט
איבערצײַטיק	י ב ע ר צ ײַ ט י ק
איבערקערן	י ב ע ר ק ע ר נ
איבערשרײַבן	י ב ע ר ש ר ײַ ב נ
איבערשפּיצטער	י ב ע ר ש פּ י צ ט ע ר
איבערשפּאַרן	י ב ע ר ש פּ אַ ר נ
איבערפֿירער	י ב ע ר פֿ י ר ע ר
איבערפֿירערס	י ב ע ר פֿ י ר ע ר ס
איז	י ז
איזן	י ז נ
איטלעכן	י ט ל ע כ נ
איטלעכס	י ט ל ע כ ס
איטלעכע	י ט ל ע כ ע
איטלעכער	י ט ל ע כ ע ר
איטע	י ט ע
איטעלע	י ט ע ל ע
איטעלען	י ט ע ל ע נ
איטען	י ט ע נ
איך	י כ
אים	י מ
אים־ייִרצע־האַשעם	י מ י יִ ר צ ע ה אַ ש ע מ
אימעצן	י מ ע צ נ
אימער	י מ ע ר
אימקײן	י מ ק ײ נ
אימשטאַנד	י מ ש ט אַ נ ד
אין	י נ
אינגערשע	י נ ג ע ר ש ע
אינדזלען	י נ ד ז ל ע נ
אינדיטשקע	י נ ד י ט ש ק ע
אינדיטשקעס	י נ ד י ט ש ק ע ס
אינדיקעס	י נ ד י ק ע ס
אינדרױסן	י נ ד ר ױ ס נ
אינהאַלט	י נ ה אַ ל ט
אינטערעסירט	י נ ט ע ר ע ס י ר ט
אינטערעסאַנטע	י נ ט ע ר ע ס אַ נ ט ע
איניען	י נ י ע נ
איניאָנים	י נ י אָ נ י מ
אינסטיטוציעס	י נ ס ט י ט ו צ י ע ס
אינסינואַציעס	י נ ס י נ ו אַ צ י ע ס
אינעם	י נ ע מ
אינעװײניק	י נ ע װ ײ נ י ק
איצט	י צ ט
איצטיקס	י צ ט י ק ס
איצטער	י צ ט ע ר
איקער	י ק ע ר
איקער־רעכן־מײַסטער	י ק ע ר ר ע כ נ מ ײַ ס ט ע ר
איקער־שוטעף	י ק ע ר ש ו ט ע פֿ
איר	י ר
אירס	י ר ס
אירע	י ר ע
אישע	י ש ע
איװרע	י װ ר ע
איװאַן	י װ אַ נ
איפּעש	י פּ ע ש
אױ	ױ
אױ־װײ	ױ װ ײ
אױב	ױ ב
אױבן	ױ ב נ
אױבן־אָן	ױ ב נ אָ נ
אױבנאָן	ױ ב נ אָ נ
אױבער־שױמער	ױ ב ע ר ש ױ מ ע ר
אױבערדעק	ױ ב ע ר ד ע ק
אױבערשטן	ױ ב ע ר ש ט נ
אױבערשטע	ױ ב ע ר ש ט ע
אױבערשטער	ױ ב ע ר ש ט ע ר
אױג	ױ ג
אױגל	ױ ג ל
אױגן	ױ ג נ
אױגנלאָך	ױ ג נ ל אָ כ
אױהעװ־ייִסראָעל	ױ ה ע װ י יִ ס ר אָ ע ל
אױזער	ױ ז ע ר
אױזערל	ױ ז ע ר ל
אױזערן	ױ ז ע ר נ
אױזערס	ױ ז ע ר ס
אױך	ױ כ
אױכעט	ױ כ ע ט
אױלע־ליגדולע	ױ ל ע ל י ג ד ו ל ע
אױלעם	ױ ל ע מ
אױלעם־אומלױע	ױ ל ע מ ו מ ל ױ ע
אױלעם־האַשעקער	ױ ל ע מ ה אַ ש ע ק ע ר
אױלעם־האָעמעס	ױ ל ע מ ה אָ ע מ ע ס
אױס	ױ ס
אױסבעסערונגען	ױ ס ב ע ס ע ר ו נ ג ע נ
אױסברעכן	ױ ס ב ר ע כ נ
אױסברענגען	ױ ס ב ר ע נ ג ע נ
אױסבײַטן	ױ ס ב ײַ ט נ
אױסגליטשן	ױ ס ג ל י ט ש נ
אױסגעבעט	ױ ס ג ע ב ע ט
אױסגעבעטע	ױ ס ג ע ב ע ט ע
אױסגעברענט	ױ ס ג ע ב ר ע נ ט
אױסגעבױגן	ױ ס ג ע ב ױ ג נ
אױסגעבױט	ױ ס ג ע ב ױ ט
אױסגעגלײַכט	ױ ס ג ע ג ל ײַ כ ט
אױסגעגעבן	ױ ס ג ע ג ע ב נ
אױסגעגעבענע	ױ ס ג ע ג ע ב ע נ ע
אױסגעגעבענער	ױ ס ג ע ג ע ב ע נ ע ר
אױסגעגאַנגען	ױ ס ג ע ג אַ נ ג ע נ
אױסגעגאָסן	ױ ס ג ע ג אָ ס נ
אױסגעדונגען	ױ ס ג ע ד ו נ ג ע נ
אױסגעדריקט	ױ ס ג ע ד ר י ק ט
אױסגעדרײט	ױ ס ג ע ד ר ײ ט
אױסגעדאַכט	ױ ס ג ע ד אַ כ ט
אױסגעדאַרטע	ױ ס ג ע ד אַ ר ט ע
אױסגעהערט	ױ ס ג ע ה ע ר ט
אױסגעהאַלטן	ױ ס ג ע ה אַ ל ט נ
אױסגעהאָרכט	ױ ס ג ע ה אָ ר כ ט
אױסגעזען	ױ ס ג ע ז ע נ
אױסגעטריקנט	ױ ס ג ע ט ר י ק נ ט
אױסגעטרעטן	ױ ס ג ע ט ר ע ט נ
אױסגעטרעטענע	ױ ס ג ע ט ר ע ט ע נ ע
אױסגעטרײסלט	ױ ס ג ע ט ר ײ ס ל ט
אױסגעטראַכט	ױ ס ג ע ט ר אַ כ ט
אױסגעטראָטענע	ױ ס ג ע ט ר אָ ט ע נ ע
אױסגעטאָן	ױ ס ג ע ט אָ נ
אױסגעלערנט	ױ ס ג ע ל ע ר נ ט
אױסגעלײזט	ױ ס ג ע ל ײ ז ט
אױסגעלײענט	ױ ס ג ע ל ײ ע נ ט
אױסגעליִען	ױ ס ג ע ל יִ ע נ
אױסגעלאָזט	ױ ס ג ע ל אָ ז ט
אױסגעלאָשן	ױ ס ג ע ל אָ ש נ
אױסגעלאָשענע	ױ ס ג ע ל אָ ש ע נ ע
אױסגעמישט	ױ ס ג ע מ י ש ט
אױסגעמאָלט	ױ ס ג ע מ אָ ל ט
אױסגענײט	ױ ס ג ע נ ײ ט
אױסגעצירט	ױ ס ג ע צ י ר ט
אױסגעצװאָגן	ױ ס ג ע צ װ אָ ג נ
אױסגעצױגן	ױ ס ג ע צ ױ ג נ
אױסגעצױגענע	ױ ס ג ע צ ױ ג ע נ ע
אױסגעצױגענער	ױ ס ג ע צ ױ ג ע נ ע ר
אױסגעצײכנט	ױ ס ג ע צ ײ כ נ ט
אױסגעקומען	ױ ס ג ע ק ו מ ע נ
אױסגעקליבן	ױ ס ג ע ק ל י ב נ
אױסגעקלעפּט	ױ ס ג ע ק ל ע פּ ט
אױסגעקערט	ױ ס ג ע ק ע ר ט
אױסגעקערעװעט	ױ ס ג ע ק ע ר ע װ ע ט
אױסגעקרימטע	ױ ס ג ע ק ר י מ ט ע
אױסגעקראַצט	ױ ס ג ע ק ר אַ צ ט
אױסגערופֿן	ױ ס ג ע ר ו פֿ נ
אױסגעריבן	ױ ס ג ע ר י ב נ
אױסגעריבענעם	ױ ס ג ע ר י ב ע נ ע מ
אױסגעריסן	ױ ס ג ע ר י ס נ
אױסגערעדט	ױ ס ג ע ר ע ד ט
אױסגערעכנט	ױ ס ג ע ר ע כ נ ט
אױסגעשטעלט	ױ ס ג ע ש ט ע ל ט
אױסגעשטעלטע	ױ ס ג ע ש ט ע ל ט ע
אױסגעשטעקט	ױ ס ג ע ש ט ע ק ט
אױסגעשטערנטער	ױ ס ג ע ש ט ע ר נ ט ע ר
אױסגעשטרעקט	ױ ס ג ע ש ט ר ע ק ט
אױסגעשטרעקטע	ױ ס ג ע ש ט ר ע ק ט ע
אױסגעשטאַנען	ױ ס ג ע ש ט אַ נ ע נ
אױסגעשלאָגן	ױ ס ג ע ש ל אָ ג נ
אױסגעשמירט	ױ ס ג ע ש מ י ר ט
אױסגעשמירטער	ױ ס ג ע ש מ י ר ט ע ר
אױסגעשניצט	ױ ס ג ע ש נ י צ ט
אױסגעשרײ	ױ ס ג ע ש ר ײ
אױסגעשאָטן	ױ ס ג ע ש אָ ט נ
אױסגעשפּיגן	ױ ס ג ע ש פּ י ג נ
אױסגעשפּילטע	ױ ס ג ע ש פּ י ל ט ע
אױסגעשפּרײט	ױ ס ג ע ש פּ ר ײ ט
אױסגעשפּאַנט	ױ ס ג ע ש פּ אַ נ ט
אױסגעװיזן	ױ ס ג ע װ י ז נ
אױסגעװישט	ױ ס ג ע װ י ש ט
אױסגעװײנט	ױ ס ג ע װ ײ נ ט
אױסגעװײנטע	ױ ס ג ע װ ײ נ ט ע
אױסגעװאַקסן	ױ ס ג ע װ אַ ק ס נ
אױסגעפּאַקט	ױ ס ג ע פּ אַ ק ט
אױסגעפֿירט	ױ ס ג ע פֿ י ר ט
אױסגײן	ױ ס ג ײ נ
אױסדערצײלן	ױ ס ד ע ר צ ײ ל נ
אױסדריקן	ױ ס ד ר י ק נ
אױסדרײען	ױ ס ד ר ײ ע נ
אױסהיטן	ױ ס ה י ט נ
אױסהערן	ױ ס ה ע ר נ
אױסהערנדיק	ױ ס ה ע ר נ ד י ק
אױסהאַלטן	ױ ס ה אַ ל ט נ
אױסזען	ױ ס ז ע נ
אױסטרינקען	ױ ס ט ר י נ ק ע נ
אױסטײַטשן	ױ ס ט ײַ ט ש נ
אױסטאָן	ױ ס ט אָ נ
אױסיעס	ױ ס י ע ס
אױסיעסלעך	ױ ס י ע ס ל ע כ
אױסכאַפּן	ױ ס כ אַ פּ נ
אױסלערנען	ױ ס ל ע ר נ ע נ
אױסלױפֿן	ױ ס ל ױ פֿ נ
אױסלאַנד	ױ ס ל אַ נ ד
אױסמײַדן	ױ ס מ ײַ ד נ
אױסמײַדנדיק	ױ ס מ ײַ ד נ ד י ק
אױסמאַכן	ױ ס מ אַ כ נ
אױסן	ױ ס נ
אױסנעמען	ױ ס נ ע מ ע נ
אױסנװײניק	ױ ס נ װ ײ נ י ק
אױסנאַרן	ױ ס נ אַ ר נ
אױסער	ױ ס ע ר
אױסצובעטלען	ױ ס צ ו ב ע ט ל ע נ
אױסצוהאַלטן	ױ ס צ ו ה אַ ל ט נ
אױסצוטראַכטן	ױ ס צ ו ט ר אַ כ ט נ
אױסצולערנען	ױ ס צ ו ל ע ר נ ע נ
אױסצולאָזן	ױ ס צ ו ל אָ ז נ
אױסצונוצן	ױ ס צ ו נ ו צ נ
אױסצוניצן	ױ ס צ ו נ י צ נ
אױסצורעדן	ױ ס צ ו ר ע ד נ
אױסצורײדן	ױ ס צ ו ר ײ ד נ
אױסקומען	ױ ס ק ו מ ע נ
אױסקוקן	ױ ס ק ו ק נ
אױסקערן	ױ ס ק ע ר נ
אױסרופֿן	ױ ס ר ו פֿ נ
אױסריכטן	ױ ס ר י כ ט נ
אױסרײדן	ױ ס ר ײ ד נ
אױסרײַסן	ױ ס ר ײַ ס נ
אױסשטעכן	ױ ס ש ט ע כ נ
אױסשטרעקנדיק	ױ ס ש ט ר ע ק נ ד י ק
אױסשטײן	ױ ס ש ט ײ נ
אױסשטײַער	ױ ס ש ט ײַ ע ר
אױסשיסן	ױ ס ש י ס נ
אױסשפּײַען	ױ ס ש פּ ײַ ע נ
אױסװײניק	ױ ס װ ײ נ י ק
אױסװײַזן	ױ ס װ ײַ ז נ
אױספֿירן	ױ ס פֿ י ר נ
אױספֿאַרקױפֿט	ױ ס פֿ אַ ר ק ױ פֿ ט
אױספֿאַרקױפֿן	ױ ס פֿ אַ ר ק ױ פֿ נ
אױען	ױ ע נ
אױער	ױ ע ר
אױערן	ױ ע ר נ
אױף	ױ פֿ
אױצער	ױ צ ע ר
אױצרעס	ױ צ ר ע ס
אױר	ױ ר
אױרינגלעך	ױ ר י נ ג ל ע כ
אױרעך	ױ ר ע כ
אױװן	ױ װ נ
אױפּס	ױ פּ ס
אױפֿגעגעסן	ױ פֿ ג ע ג ע ס נ
אױפֿגעגעסענע	ױ פֿ ג ע ג ע ס ע נ ע
אױפֿגעגאַנגען	ױ פֿ ג ע ג אַ נ ג ע נ
אױפֿגעהערט	ױ פֿ ג ע ה ע ר ט
אױפֿגעהױבן	ױ פֿ ג ע ה ױ ב נ
אױפֿגעהאַלטן	ױ פֿ ג ע ה אַ ל ט נ
אױפֿגעהאַנגען	ױ פֿ ג ע ה אַ נ ג ע נ
אױפֿגעהאָנגען	ױ פֿ ג ע ה אָ נ ג ע נ
אױפֿגעיױרענע	ױ פֿ ג ע י ױ ר ע נ ע
אױפֿגעכאַפּט	ױ פֿ ג ע כ אַ פּ ט
אױפֿגעכאַפּטן	ױ פֿ ג ע כ אַ פּ ט נ
אױפֿגעלײגט	ױ פֿ ג ע ל ײ ג ט
אױפֿגעלאָפֿן	ױ פֿ ג ע ל אָ פֿ נ
אױפֿגעעפֿנט	ױ פֿ ג ע ע פֿ נ ט
אױפֿגעציטערט	ױ פֿ ג ע צ י ט ע ר ט
אױפֿגעצױגן	ױ פֿ ג ע צ ױ ג נ
אױפֿגעקומען	ױ פֿ ג ע ק ו מ ע נ
אױפֿגעריכט	ױ פֿ ג ע ר י כ ט
אױפֿגעריסענע	ױ פֿ ג ע ר י ס ע נ ע
אױפֿגעשטעלטע	ױ פֿ ג ע ש ט ע ל ט ע
אױפֿגעשטײַגט	ױ פֿ ג ע ש ט ײַ ג ט
אױפֿגעשטאַנען	ױ פֿ ג ע ש ט אַ נ ע נ
אױפֿגעשײַנט	ױ פֿ ג ע ש ײַ נ ט
אױפֿגעשפּרונגען	ױ פֿ ג ע ש פּ ר ו נ ג ע נ
אױפֿגעפֿלאַמט	ױ פֿ ג ע פֿ ל אַ מ ט
אױפֿגאָב	ױ פֿ ג אָ ב
אױפֿהענגען	ױ פֿ ה ע נ ג ע נ
אױפֿהערן	ױ פֿ ה ע ר נ
אױפֿהײבן	ױ פֿ ה ײ ב נ
אױפֿכאַפּן	ױ פֿ כ אַ פּ נ
אױפֿן	ױ פֿ נ
אױפֿס	ױ פֿ ס
אױפֿעסן	ױ פֿ ע ס נ
אױפֿצוהױבן	ױ פֿ צ ו ה ױ ב נ
אױפֿצוזעצן	ױ פֿ צ ו ז ע צ נ
אױפֿצושטײן	ױ פֿ צ ו ש ט ײ נ
אױפֿצושטײַגן	ױ פֿ צ ו ש ט ײַ ג נ
אױפֿקלערן	ױ פֿ ק ל ע ר נ
אױפֿשטײן	ױ פֿ ש ט ײ נ
אײביק	ײ ב י ק
אײבערשטע	ײ ב ע ר ש ט ע
אײגל	ײ ג ל
אײגן	ײ ג נ
אײגנטלעך	ײ ג נ ט ל ע כ
אײגעלעך	ײ ג ע ל ע כ
אײגענע	ײ ג ע נ ע
אײגענעם	ײ ג ע נ ע מ
אײגענער	ײ ג ע נ ע ר
אײדל	ײ ד ל
אײדל־גלאַטע	ײ ד ל ג ל אַ ט ע
אײדע	ײ ד ע
אײדעלן	ײ ד ע ל נ
אײדעלע	ײ ד ע ל ע
אײדעלער	ײ ד ע ל ע ר
אײדעם	ײ ד ע מ
אײדעמס	ײ ד ע מ ס
אײדעס	ײ ד ע ס
אײדער	ײ ד ע ר
אײל	ײ ל
אײלן	ײ ל נ
אײמע	ײ מ ע
אײמעדיקע	ײ מ ע ד י ק ע
אײן	ײ נ
אײנהאָרע	ײ נ ה אָ ר ע
אײנזאַם	ײ נ ז אַ מ
אײנזאַמע	ײ נ ז אַ מ ע
אײנזאַמער	ײ נ ז אַ מ ע ר
אײניקל	ײ נ י ק ל
אײניקלעך	ײ נ י ק ל ע כ
אײניקע	ײ נ י ק ע
אײנס	ײ נ ס
אײנע	ײ נ ע
אײנעם	ײ נ ע מ
אײנער	ײ נ ע ר
אײנציקן	ײ נ צ י ק נ
אײנציקע	ײ נ צ י ק ע
אײנציקער	ײ נ צ י ק ע ר
אײנציקװײַז	ײ נ צ י ק װ ײַ ז
אײנצלנע	ײ נ צ ל נ ע
אײסעק	ײ ס ע ק
אײער־בײגל	ײ ע ר ב ײ ג ל
אײער־קיכלעך	ײ ע ר ק י כ ל ע כ
אײער־קנאַקן	ײ ע ר ק נ אַ ק נ
אײערנעכטיק	ײ ע ר נ ע כ ט י ק
אײצים	ײ צ י מ
אײצע	ײ צ ע
אײצעס	ײ צ ע ס
אײראָפּע	ײ ר אָ פּ ע
אײראָפּעיִשע	ײ ר אָ פּ ע יִ ש ע
אײש־לעהאָװע	ײ ש ל ע ה אָ װ ע
אײשישאָק	ײ ש י ש אָ ק
אײשעס־איש	ײ ש ע ס י ש
אײװער	ײ װ ע ר
אײװאָרים	ײ װ אָ ר י מ
איִעװ	יִ ע װ
אײַ	ײַ
אײַ־אײַ־אײַ	ײַ ײַ ײַ
אײַז	ײַ ז
אײַזהױך	ײַ ז ה ױ כ
אײַזן	ײַ ז נ
אײַזערן	ײַ ז ע ר נ
אײַך	ײַ כ
אײַלט	ײַ ל ט
אײַלעניש	ײַ ל ע נ י ש
אײַן	ײַ נ
אײַנבינדער	ײַ נ ב י נ ד ע ר
אײַנגעבעטן	ײַ נ ג ע ב ע ט נ
אײַנגעבראָכן	ײַ נ ג ע ב ר אָ כ נ
אײַנגעבױגענע	ײַ נ ג ע ב ױ ג ע נ ע
אײַנגעבױגענער	ײַ נ ג ע ב ױ ג ע נ ע ר
אײַנגעגעסענע	ײַ נ ג ע ג ע ס ע נ ע
אײַנגעגאַנגען	ײַ נ ג ע ג אַ נ ג ע נ
אײַנגעדרעמלט	ײַ נ ג ע ד ר ע מ ל ט
אײַנגעדאַרטס	ײַ נ ג ע ד אַ ר ט ס
אײַנגעדאַרטע	ײַ נ ג ע ד אַ ר ט ע
אײַנגעהילט	ײַ נ ג ע ה י ל ט
אײַנגעהאַלטענער	ײַ נ ג ע ה אַ ל ט ע נ ע ר
אײַנגעהאַנדלט	ײַ נ ג ע ה אַ נ ד ל ט
אײַנגעהאָרכט	ײַ נ ג ע ה אָ ר כ ט
אײַנגעזונקען	ײַ נ ג ע ז ו נ ק ע נ
אײַנגעטוליעט	ײַ נ ג ע ט ו ל י ע ט
אײַנגעטונקט	ײַ נ ג ע ט ו נ ק ט
אײַנגעטונקען	ײַ נ ג ע ט ו נ ק ע נ
אײַנגעטײלט	ײַ נ ג ע ט ײ ל ט
אײַנגעלױף	ײַ נ ג ע ל ױ פֿ
אײַנגעלײגט	ײַ נ ג ע ל ײ ג ט
אײַנגעלאַדן	ײַ נ ג ע ל אַ ד נ
אײַנגעמאַכטס	ײַ נ ג ע מ אַ כ ט ס
אײַנגעמאַכטסן	ײַ נ ג ע מ אַ כ ט ס נ
אײַנגענומען	ײַ נ ג ע נ ו מ ע נ
אײַנגענעם	ײַ נ ג ע נ ע מ
אײַנגעקנײטשטן	ײַ נ ג ע ק נ ײ ט ש ט נ
אײַנגעקנײטשטס	ײַ נ ג ע ק נ ײ ט ש ט ס
אײַנגעקנײטשטער	ײַ נ ג ע ק נ ײ ט ש ט ע ר
אײַנגערױמט	ײַ נ ג ע ר ױ מ ט
אײַנגעשטימט	ײַ נ ג ע ש ט י מ ט
אײַנגעשטאַנען	ײַ נ ג ע ש ט אַ נ ע נ
אײַנגעשלאָפֿן	ײַ נ ג ע ש ל אָ פֿ נ
אײַנגעשרומפּענע	ײַ נ ג ע ש ר ו מ פּ ע נ ע
אײַנגעשריבן	ײַ נ ג ע ש ר י ב נ
אײַנגעשפּאַנט	ײַ נ ג ע ש פּ אַ נ ט
אײַנגעשפּאַרט	ײַ נ ג ע ש פּ אַ ר ט
אײַנגעװיקלט	ײַ נ ג ע װ י ק ל ט
אײַנגעװױנט	ײַ נ ג ע װ ױ נ ט
אײַנגעפֿירט	ײַ נ ג ע פֿ י ר ט
אײַנגעפֿלאַנצט	ײַ נ ג ע פֿ ל אַ נ צ ט
אײַנגעפֿלאָכטן	ײַ נ ג ע פֿ ל אָ כ ט נ
אײַנגעפֿרױרן	ײַ נ ג ע פֿ ר ױ ר נ
אײַנגעפֿרױרענע	ײַ נ ג ע פֿ ר ױ ר ע נ ע
אײַנגעפֿאַלן	ײַ נ ג ע פֿ אַ ל נ
אײַנגעפֿאַלענע	ײַ נ ג ע פֿ אַ ל ע נ ע
אײַנגעפֿאַסט	ײַ נ ג ע פֿ אַ ס ט
אײַנגײער	ײַ נ ג ײ ע ר
אײַנגײערין	ײַ נ ג ײ ע ר י נ
אײַנדרוק	ײַ נ ד ר ו ק
אײַנהײצן	ײַ נ ה ײ צ נ
אײַנהאַלטן	ײַ נ ה אַ ל ט נ
אײַנזיצן	ײַ נ ז י צ נ
אײַננעמען	ײַ נ נ ע מ ע נ
אײַנצוהאַנדלען	ײַ נ צ ו ה אַ נ ד ל ע נ
אײַנצושלינגען	ײַ נ צ ו ש ל י נ ג ע נ
אײַנשטודירן	ײַ נ ש ט ו ד י ר נ
אײַנשטעלן	ײַ נ ש ט ע ל נ
אײַנשטײן	ײַ נ ש ט ײ נ
אײַנשלאָפֿן	ײַ נ ש ל אָ פֿ נ
אײַנשרײַבן	ײַ נ ש ר ײַ ב נ
אײַנשפּאַנען	ײַ נ ש פּ אַ נ ע נ
אײַנװאַשן	ײַ נ װ אַ ש נ
אײַנפֿאַלן	ײַ נ פֿ אַ ל נ
אײַען	ײַ ע נ
אײַער	ײַ ע ר
אײַערן	ײַ ע ר נ
אײַערס	ײַ ע ר ס
אײַערע	ײַ ע ר ע
אײַערער	ײַ ע ר ע ר
אײַיִר	ײַ יִ ר
אוּװעזכוס־זע	וּ װ ע ז כ ו ס ז ע
בוזעם־קעשענע	ב ו ז ע מ ק ע ש ע נ ע
בוטלקװאַס	ב ו ט ל ק װ אַ ס
בוך	ב ו כ
בוכשטאַב	ב ו כ ש ט אַ ב
בוליאָן	ב ו ל י אָ נ
בולקע	ב ו ל ק ע
בולקעלעך	ב ו ל ק ע ל ע כ
בולאַנעס	ב ו ל אַ נ ע ס
בונד	ב ו נ ד
בונדן	ב ו נ ד נ
בונטיקע	ב ו נ ט י ק ע
בורטשען	ב ו ר ט ש ע נ
בוריקע־באָרשט	ב ו ר י ק ע ב אָ ר ש ט
בורעק	ב ו ר ע ק
בושע	ב ו ש ע
בושעס־האַמעס	ב ו ש ע ס ה אַ מ ע ס
בופֿלאַקס	ב ו פֿ ל אַ ק ס
בידנע	ב י ד נ ע
ביז	ב י ז
ביזיױנעס	ב י ז י ױ נ ע ס
ביזן	ב י ז נ
ביזױען	ב י ז ױ ע נ
ביטנײַ	ב י ט נ ײַ
ביטער	ב י ט ע ר
ביטערע	ב י ט ע ר ע
ביטאָכן	ב י ט אָ כ נ
ביכדײ	ב י כ ד ײ
ביכל	ב י כ ל
בילדער	ב י ל ד ע ר
ביליק	ב י ל י ק
ביליקע	ב י ל י ק ע
ביליקער	ב י ל י ק ע ר
בילכער	ב י ל כ ע ר
בילן	ב י ל נ
בים־באָם	ב י מ ב אָ מ
בימבאָם	ב י מ ב אָ מ
בין	ב י נ
בינדט	ב י נ ד ט
בינטל	ב י נ ט ל
בינטלעך	ב י נ ט ל ע כ
ביסט	ב י ס ט
ביסטו	ב י ס ט ו
ביסל	ב י ס ל
ביסלעכװײַז	ב י ס ל ע כ װ ײַ ז
ביסן	ב י ס נ
ביסעלע	ב י ס ע ל ע
ביר	ב י ר
בירגער	ב י ר ג ע ר
בירכאָסאָ	ב י ר כ אָ ס אָ
ביפֿראַט	ב י פֿ ר אַ ט
בלוט	ב ל ו ט
בלוט־שפּראָצנדיקע	ב ל ו ט ש פּ ר אָ צ נ ד י ק ע
בלוטיק	ב ל ו ט י ק
בלוטיקן	ב ל ו ט י ק נ
בלוטן	ב ל ו ט נ
בלומען	ב ל ו מ ע נ
בלומען־געשמאַק	ב ל ו מ ע נ ג ע ש מ אַ ק
בלומען־פֿאַרקאָװעטן	ב ל ו מ ע נ פֿ אַ ר ק אָ װ ע ט נ
בליטשקע	ב ל י ט ש ק ע
בלינדן	ב ל י נ ד נ
בלינדער	ב ל י נ ד ע ר
בליק	ב ל י ק
בלישטשעט	ב ל י ש ט ש ע ט
בלישטשען	ב ל י ש ט ש ע נ
בלעטל	ב ל ע ט ל
בלעטלעך	ב ל ע ט ל ע כ
בלעטעלעך	ב ל ע ט ע ל ע כ
בלעטער	ב ל ע ט ע ר
בלעך	ב ל ע כ
בלעכל	ב ל ע כ ל
בלעכנס	ב ל ע כ נ ס
בלעכענעם	ב ל ע כ ע נ ע מ
בלױ	ב ל ױ
בלױז	ב ל ױ ז
בלױזע	ב ל ױ ז ע
בלױע	ב ל ױ ע
בלױען	ב ל ױ ע נ
בלױער	ב ל ױ ע ר
בלײכע	ב ל ײ כ ע
בלײכער	ב ל ײ כ ע ר
בליִען	ב ל יִ ע נ
בלײַב	ב ל ײַ ב
בלײַבט	ב ל ײַ ב ט
בלײַבן	ב ל ײַ ב נ
בלײַענע	ב ל ײַ ע נ ע
בלײַענעם	ב ל ײַ ע נ ע מ
בלײַשטיפֿטן	ב ל ײַ ש ט י פֿ ט נ
בלאַט	ב ל אַ ט
בלאַנקט	ב ל אַ נ ק ט
בלאַנקען	ב ל אַ נ ק ע נ
בלאַס	ב ל אַ ס
בלאָז	ב ל אָ ז
בלאָזט	ב ל אָ ז ט
בלאָטיק	ב ל אָ ט י ק
בלאָטע	ב ל אָ ט ע
בלאָנדזשעט	ב ל אָ נ ד ז ש ע ט
בלאָנדזשען	ב ל אָ נ ד ז ש ע נ
בלאָנדע	ב ל אָ נ ד ע
בנײבאַיִס	ב נ ײ ב אַ יִ ס
בע	ב ע
בע־ייִכעד	ב ע י יִ כ ע ד
בעגעד	ב ע ג ע ד
בעגאָדים	ב ע ג אָ ד י מ
בעדער	ב ע ד ע ר
בעדערס	ב ע ד ע ר ס
בעדײע	ב ע ד ײ ע
בעהען־שעלי	ב ע ה ע נ ש ע ל י
בעהײמע	ב ע ה ײ מ ע
בעהײמעלע	ב ע ה ײ מ ע ל ע
בעהײמעס	ב ע ה ײ מ ע ס
בעהאָלע	ב ע ה אָ ל ע
בעזדן	ב ע ז ד נ
בעזדן־שטוב	ב ע ז ד נ ש ט ו ב
בעזדן־שעל־מײַלע	ב ע ז ד נ ש ע ל מ ײַ ל ע
בעט	ב ע ט
בעטגעװאַנט	ב ע ט ג ע װ אַ נ ט
בעטועך	ב ע ט ו ע כ
בעטל	ב ע ט ל
בעטלער	ב ע ט ל ע ר
בעטן	ב ע ט נ
בעטעװע	ב ע ט ע װ ע
בעטײ	ב ע ט ײ
בעיערושע	ב ע י ע ר ו ש ע
בעיעשיװע	ב ע י ע ש י װ ע
בעך	ב ע כ
בעכעצי־כינעם	ב ע כ ע צ י כ י נ ע מ
בעכערלעך	ב ע כ ע ר ל ע כ
בעכײן	ב ע כ ײ נ
בעכײרעם	ב ע כ ײ ר ע מ
בעכאָל־טפֿוצעס־ייִסראָעל	ב ע כ אָ ל ט פֿ ו צ ע ס י יִ ס ר אָ ע ל
בעלמע	ב ע ל מ ע
בעלע	ב ע ל ע
בעלױ־גוזמע	ב ע ל ױ ג ו ז מ ע
בעמינעג	ב ע מ י נ ע ג
בעמײלע	ב ע מ ײ ל ע
בעמאַטאָנע	ב ע מ אַ ט אָ נ ע
בענדער	ב ע נ ד ע ר
בענדערנע	ב ע נ ד ע ר נ ע
בענטשט	ב ע נ ט ש ט
בענטשן	ב ע נ ט ש נ
בענימעסדיק	ב ע נ י מ ע ס ד י ק
בעניע	ב ע נ י ע
בענעמאָנעס	ב ע נ ע מ אָ נ ע ס
בענק	ב ע נ ק
בענקט	ב ע נ ק ט
בענקל	ב ע נ ק ל
בענקעלע	ב ע נ ק ע ל ע
בענקען	ב ע נ ק ע נ
בענקעניש	ב ע נ ק ע נ י ש
בעסטן	ב ע ס ט נ
בעסטע	ב ע ס ט ע
בעסטער	ב ע ס ט ע ר
בעסמעדרעש	ב ע ס מ ע ד ר ע ש
בעסמעדרעש־פֿענצטער	ב ע ס מ ע ד ר ע ש פֿ ע נ צ ט ע ר
בעסמעדרעשל	ב ע ס מ ע ד ר ע ש ל
בעסער	ב ע ס ע ר
בעסערן	ב ע ס ע ר נ
בעסױלעם	ב ע ס ױ ל ע מ
בעער־מאַיִם־כאַיִם	ב ע ע ר מ אַ יִ מ כ אַ יִ מ
בעצאַלעל	ב ע צ אַ ל ע ל
בעקיצער	ב ע ק י צ ע ר
בעקן	ב ע ק נ
בעקנס	ב ע ק נ ס
בעקעלעך	ב ע ק ע ל ע כ
בעקער	ב ע ק ע ר
בעקערס	ב ע ק ע ר ס
בעקערײַ	ב ע ק ע ר ײַ
בעקאָװעדיקערע	ב ע ק אָ װ ע ד י ק ע ר ע
בערג	ב ע ר ג
בערגל	ב ע ר ג ל
בערגער	ב ע ר ג ע ר
בערגאַמאָטן	ב ע ר ג אַ מ אָ ט נ
בערד	ב ע ר ד
בערדל	ב ע ר ד ל
בעריע	ב ע ר י ע
בעריעשאַפֿט	ב ע ר י ע ש אַ פֿ ט
בערישע	ב ע ר י ש ע
בערל	ב ע ר ל
בערלינקעס	ב ע ר ל י נ ק ע ס
בערלען	ב ע ר ל ע נ
בעראָװ	ב ע ר אָ װ
בעשום־איניען־װעױפֿן	ב ע ש ו מ י נ י ע נ װ ע ױ פֿ נ
בעשום־אױפֿן	ב ע ש ו מ ױ פֿ נ
בעשױפֿער	ב ע ש ױ פֿ ע ר
בעשאַס	ב ע ש אַ ס
בעשאַס־האַדאַכעק	ב ע ש אַ ס ה אַ ד אַ כ ע ק
בעשאַס־האַדאָכאַק	ב ע ש אַ ס ה אַ ד אָ כ אַ ק
בעשאַס־מײַסע	ב ע ש אַ ס מ ײַ ס ע
בעשאָלעם	ב ע ש אָ ל ע מ
בעפֿײרעש	ב ע פֿ ײ ר ע ש
ברודיקע	ב ר ו ד י ק ע
ברודער	ב ר ו ד ע ר
ברודערל	ב ר ו ד ע ר ל
ברודערס	ב ר ו ד ע ר ס
ברומט	ב ר ו מ ט
ברונעם	ב ר ו נ ע מ
ברוסט	ב ר ו ס ט
ברוק	ב ר ו ק
ברויִם	ב ר ו יִ מ
ברידער	ב ר י ד ע ר
ברידערלעך	ב ר י ד ע ר ל ע כ
בריטשקע	ב ר י ט ש ק ע
בריליאַנט	ב ר י ל י אַ נ ט
בריליאַנטן	ב ר י ל י אַ נ ט נ
בריליאַנטענע	ב ר י ל י אַ נ ט ע נ ע
ברילן	ב ר י ל נ
בריס	ב ר י ס
בריסט	ב ר י ס ט
בריסטן	ב ר י ס ט נ
בריסמילע	ב ר י ס מ י ל ע
בריװ	ב ר י װ
בריװל	ב ר י װ ל
בריװעלע	ב ר י װ ע ל ע
ברעג	ב ר ע ג
ברעטל	ב ר ע ט ל
ברעטער	ב ר ע ט ע ר
ברעך	ב ר ע כ
ברעכט	ב ר ע כ ט
ברעכן	ב ר ע כ נ
ברעם	ב ר ע מ
ברעמען	ב ר ע מ ע נ
ברען	ב ר ע נ
ברענגט	ב ר ע נ ג ט
ברענגען	ב ר ע נ ג ע נ
ברענט	ב ר ע נ ט
ברענען	ב ר ע נ ע נ
ברענענדיקע	ב ר ע נ ע נ ד י ק ע
ברױגעז	ב ר ױ ג ע ז
ברױגעז־מינע	ב ר ױ ג ע ז מ י נ ע
ברױט	ב ר ױ ט
ברױן	ב ר ױ נ
ברײט	ב ר ײ ט
ברײט־בײניקער	ב ר ײ ט ב ײ נ י ק ע ר
ברײטן	ב ר ײ ט נ
ברײטס	ב ר ײ ט ס
ברײטסטע	ב ר ײ ט ס ט ע
ברײטע	ב ר ײ ט ע
ברײטער	ב ר ײ ט ע ר
ברײרע	ב ר ײ ר ע
בריִענדיק	ב ר יִ ע נ ד י ק
בריִענדיקע	ב ר יִ ע נ ד י ק ע
ברײַען	ב ר ײַ ע נ
בראַט	ב ר אַ ט
בראָט	ב ר אָ ט
בראָטן	ב ר אָ ט נ
בראָטפֿאַנען	ב ר אָ ט פֿ אַ נ ע נ
בראָך	ב ר אָ כ
בראָכע	ב ר אָ כ ע
בראָכען	ב ר אָ כ ע נ
בראָכעס	ב ר אָ כ ע ס
בראָנפֿן	ב ר אָ נ פֿ נ
בראָנפֿנס	ב ר אָ נ פֿ נ ס
בראָצקי	ב ר אָ צ ק י
בראָקן	ב ר אָ ק נ
בשעתן	ב ש ע ת נ
בױבעריק	ב ױ ב ע ר י ק
בױבעריקער	ב ױ ב ע ר י ק ע ר
בױגט	ב ױ ג ט
בױגל	ב ױ ג ל
בױגן	ב ױ ג נ
בױדעם	ב ױ ד ע מ
בױך	ב ױ כ
בױם	ב ױ מ
בױמל	ב ױ מ ל
בױמס	ב ױ מ ס
בױמער	ב ױ מ ע ר
בױען	ב ױ ע נ
בױרע	ב ױ ר ע
בײגט	ב ײ ג ט
בײגל	ב ײ ג ל
בײגל־בעקער	ב ײ ג ל ב ע ק ע ר
בײדן	ב ײ ד נ
בײדע	ב ײ ד ע
בײזן	ב ײ ז נ
בײזע	ב ײ ז ע
בײזער	ב ײ ז ע ר
בײזערט	ב ײ ז ע ר ט
בײמל	ב ײ מ ל
בײמלעך	ב ײ מ ל ע כ
בײמעלע	ב ײ מ ע ל ע
בײמעלעך	ב ײ מ ע ל ע כ
בײמער	ב ײ מ ע ר
בײן	ב ײ נ
בײנדל	ב ײ נ ד ל
בײנער	ב ײ נ ע ר
בײנערדיקע	ב ײ נ ע ר ד י ק ע
בײס	ב ײ ס
בײס־האַמיגדעש	ב ײ ס ה אַ מ י ג ד ע ש
בײס־האַמעדרעש	ב ײ ס ה אַ מ ע ד ר ע ש
בײס־האַמעדרעש־געסל	ב ײ ס ה אַ מ ע ד ר ע ש ג ע ס ל
בײצים	ב ײ צ י מ
בײַ	ב ײַ
בײַגעטראָגן	ב ײַ ג ע ט ר אָ ג נ
בײַדל	ב ײַ ד ל
בײַט	ב ײַ ט
בײַטל	ב ײַ ט ל
בײַטן	ב ײַ ט נ
בײַטש	ב ײַ ט ש
בײַטשן	ב ײַ ט ש נ
בײַכיקע	ב ײַ כ י ק ע
בײַכל	ב ײַ כ ל
בײַכלעך	ב ײַ כ ל ע כ
בײַכער	ב ײַ כ ע ר
בײַם	ב ײַ מ
בײַנאַנד	ב ײַ נ אַ נ ד
בײַס	ב ײַ ס
בײַשפּיל	ב ײַ ש פּ י ל
בשׂימחה	ב שׂ י מ ח ה
באַבולע	ב אַ ב ו ל ע
באַגילדעט	ב אַ ג י ל ד ע ט
באַגליקן	ב אַ ג ל י ק נ
באַגעגנט	ב אַ ג ע ג נ ט
באַגעגענישן	ב אַ ג ע ג ע נ י ש נ
באַגערן	ב אַ ג ע ר נ
באַגראָבן	ב אַ ג ר אָ ב נ
באַגײן	ב אַ ג ײ נ
באַגײַסטערונג	ב אַ ג ײַ ס ט ע ר ו נ ג
באַדינג	ב אַ ד י נ ג
באַדעקט	ב אַ ד ע ק ט
באַדעקן	ב אַ ד ע ק נ
באַדױערט	ב אַ ד ױ ע ר ט
באַדױערן	ב אַ ד ױ ע ר נ
באַדײַט	ב אַ ד ײַ ט
באַדאַרף	ב אַ ד אַ ר פֿ
באַדאַרפֿט	ב אַ ד אַ ר פֿ ט
באַדאַרפֿן	ב אַ ד אַ ר פֿ נ
באַהיט	ב אַ ה י ט
באַהעלט	ב אַ ה ע ל ט
באַהעלטעניש	ב אַ ה ע ל ט ע נ י ש
באַהעלפֿער	ב אַ ה ע ל פֿ ע ר
באַהעפֿט	ב אַ ה ע פֿ ט
באַהױכט	ב אַ ה ױ כ ט
באַהאַלט	ב אַ ה אַ ל ט
באַהאַלטן	ב אַ ה אַ ל ט נ
באַהאַלטענע	ב אַ ה אַ ל ט ע נ ע
באַהאַלטענער	ב אַ ה אַ ל ט ע נ ע ר
באַהאַנגען	ב אַ ה אַ נ ג ע נ
באַהאָפֿטן	ב אַ ה אָ פֿ ט נ
באַזוכן	ב אַ ז ו כ נ
באַזונדער	ב אַ ז ו נ ד ע ר
באַזונדערן	ב אַ ז ו נ ד ע ר נ
באַזונדערע	ב אַ ז ו נ ד ע ר ע
באַזונדערער	ב אַ ז ו נ ד ע ר ע ר
באַזעצט	ב אַ ז ע צ ט
באַטראַכט	ב אַ ט ר אַ כ ט
באַטראַכטן	ב אַ ט ר אַ כ ט נ
באַטאַמט	ב אַ ט אַ מ ט
באַטאַפּן	ב אַ ט אַ פּ נ
באַכורים	ב אַ כ ו ר י מ
באַכײנט	ב אַ כ ײ נ ט
באַל־לאָשנקױדעש	ב אַ ל ל אָ ש נ ק ױ ד ע ש
באַלד	ב אַ ל ד
באַלטענאַך	ב אַ ל ט ע נ אַ כ
באַלטױװע	ב אַ ל ט ױ װ ע
באַלייִכעס	ב אַ ל י יִ כ ע ס
באַלכעזשבם	ב אַ ל כ ע ז ש ב מ
באַלכױװעס	ב אַ ל כ ױ װ ע ס
באַלמעלאָכע	ב אַ ל מ ע ל אָ כ ע
באַלמעלאָכעס	ב אַ ל מ ע ל אָ כ ע ס
באַלן	ב אַ ל נ
באַלניצאָכן	ב אַ ל נ י צ אָ כ נ
באַלע־כױװעס	ב אַ ל ע כ ױ װ ע ס
באַלע־מעלאָכעס	ב אַ ל ע מ ע ל אָ כ ע ס
באַלע־אַװײרעס	ב אַ ל ע אַ װ ײ ר ע ס
באַלעבאַטים	ב אַ ל ע ב אַ ט י מ
באַלעבאַטיש	ב אַ ל ע ב אַ ט י ש
באַלעבאַטישן	ב אַ ל ע ב אַ ט י ש נ
באַלעבאַטישע	ב אַ ל ע ב אַ ט י ש ע
באַלעבאַטישקײט	ב אַ ל ע ב אַ ט י ש ק ײ ט
באַלעבאָס	ב אַ ל ע ב אָ ס
באַלעבאָסטע	ב אַ ל ע ב אָ ס ט ע
באַלעבאָסטעס	ב אַ ל ע ב אָ ס ט ע ס
באַלעגאָלעס	ב אַ ל ע ג אָ ל ע ס
באַלצדאָקע	ב אַ ל צ ד אָ ק ע
באַלקן	ב אַ ל ק נ
באַלקע	ב אַ ל ק ע
באַלקאָרכעכאָ	ב אַ ל ק אָ ר כ ע כ אָ
באַלקאָרכאָך	ב אַ ל ק אָ ר כ אָ כ
באַלױכטן	ב אַ ל ױ כ ט נ
באַלױנט	ב אַ ל ױ נ ט
באַלײגט	ב אַ ל ײ ג ט
באַלײדיקט	ב אַ ל ײ ד י ק ט
באַלײע	ב אַ ל ײ ע
באַלאַװײרעניק	ב אַ ל אַ װ ײ ר ע נ י ק
באַלאָנים	ב אַ ל אָ נ י מ
באַלפּאַרנאָסע	ב אַ ל פּ אַ ר נ אָ ס ע
באַמערק	ב אַ מ ע ר ק
באַמערקונג	ב אַ מ ע ר ק ו נ ג
באַמערקונגען	ב אַ מ ע ר ק ו נ ג ע נ
באַמערקט	ב אַ מ ע ר ק ט
באַמערקן	ב אַ מ ע ר ק נ
באַמערקנדיק	ב אַ מ ע ר ק נ ד י ק
באַן	ב אַ נ
באַנג	ב אַ נ ג
באַנד	ב אַ נ ד
באַנק	ב אַ נ ק
באַנקעלעך	ב אַ נ ק ע ל ע כ
באַנקעס	ב אַ נ ק ע ס
באַנקראָטירט	ב אַ נ ק ר אָ ט י ר ט
באַנשער	ב אַ נ ש ע ר
באַסזקײנים	ב אַ ס ז ק ײ נ י מ
באַצאָלט	ב אַ צ אָ ל ט
באַצאָלן	ב אַ צ אָ ל נ
באַק	ב אַ ק
באַקום	ב אַ ק ו מ
באַקומט	ב אַ ק ו מ ט
באַקומען	ב אַ ק ו מ ע נ
באַקומענדיק	ב אַ ק ו מ ע נ ד י ק
באַקוקט	ב אַ ק ו ק ט
באַקוקן	ב אַ ק ו ק נ
באַקט	ב אַ ק ט
באַקלײדט	ב אַ ק ל ײ ד ט
באַקלאַפּט	ב אַ ק ל אַ פּ ט
באַקלאַפּעכץ	ב אַ ק ל אַ פּ ע כ צ
באַקלאָגט	ב אַ ק ל אָ ג ט
באַקלאָגן	ב אַ ק ל אָ ג נ
באַקן	ב אַ ק נ
באַקענען	ב אַ ק ע נ ע נ
באַקאַנט	ב אַ ק אַ נ ט
באַקאַנטן	ב אַ ק אַ נ ט נ
באַקאַנטע	ב אַ ק אַ נ ט ע
באַקאַנטער	ב אַ ק אַ נ ט ע ר
באַקאָשע	ב אַ ק אָ ש ע
באַר	ב אַ ר
באַרג	ב אַ ר ג
באַרג־אַראָפּ	ב אַ ר ג אַ ר אָ פּ
באַרדאַאַס	ב אַ ר ד אַ אַ ס
באַרויִקן	ב אַ ר ו יִ ק נ
באַרימט	ב אַ ר י מ ט
באַרימטע	ב אַ ר י מ ט ע
באַרימטער	ב אַ ר י מ ט ע ר
באַרימען	ב אַ ר י מ ע נ
באַרירט	ב אַ ר י ר ט
באַרמיצװע	ב אַ ר מ י צ װ ע
באַרמאַזל	ב אַ ר מ אַ ז ל
באַרן	ב אַ ר נ
באַרנעס	ב אַ ר נ ע ס
באַרעכנט	ב אַ ר ע כ נ ט
באַראָטן	ב אַ ר אָ ט נ
באַשולדיקונג	ב אַ ש ו ל ד י ק ו נ ג
באַשטימט	ב אַ ש ט י מ ט
באַשטעלט	ב אַ ש ט ע ל ט
באַשטענדיק	ב אַ ש ט ע נ ד י ק
באַשטענדיקע	ב אַ ש ט ע נ ד י ק ע
באַשטענדיקער	ב אַ ש ט ע נ ד י ק ע ר
באַשטײט	ב אַ ש ט ײ ט
באַשטײן	ב אַ ש ט ײ נ
באַשיצט	ב אַ ש י צ ט
באַשיצן	ב אַ ש י צ נ
באַשערט	ב אַ ש ע ר ט
באַשעפֿעניש	ב אַ ש ע פֿ ע נ י ש
באַשעפֿער	ב אַ ש ע פֿ ע ר
באַשריבן	ב אַ ש ר י ב נ
באַשרײַבן	ב אַ ש ר ײַ ב נ
באַשײַמפּערלעך	ב אַ ש ײַ מ פּ ע ר ל ע כ
באַשאַפֿן	ב אַ ש אַ פֿ נ
באַשפּיגן	ב אַ ש פּ י ג נ
באַשפּריצט	ב אַ ש פּ ר י צ ט
באַשפּײַט	ב אַ ש פּ ײַ ט
באַװיזן	ב אַ װ י ז נ
באַװעבט	ב אַ װ ע ב ט
באַװעגט	ב אַ װ ע ג ט
באַװעגן	ב אַ װ ע ג נ
באַװױגן	ב אַ װ ױ ג נ
באַװײנען	ב אַ װ ײ נ ע נ
באַװײַבטער	ב אַ װ ײַ ב ט ע ר
באַװײַז	ב אַ װ ײַ ז
באַװײַזט	ב אַ װ ײַ ז ט
באַװײַזן	ב אַ װ ײַ ז נ
באַװאַקסענער	ב אַ װ אַ ק ס ע נ ע ר
באַװאָרנט	ב אַ װ אָ ר נ ט
באַװאָרענען	ב אַ װ אָ ר ע נ ע נ
באַװוּסט	ב אַ װ וּ ס ט
באַװוּסטן	ב אַ װ וּ ס ט נ
באַפֿלעקטע	ב אַ פֿ ל ע ק ט ע
באַפֿעל	ב אַ פֿ ע ל
באַפֿעלט	ב אַ פֿ ע ל ט
באַפֿעלן	ב אַ פֿ ע ל נ
באַפֿעסטיקט	ב אַ פֿ ע ס ט י ק ט
באַפֿרישט	ב אַ פֿ ר י ש ט
באַפֿרײַנדעט	ב אַ פֿ ר ײַ נ ד ע ט
באַפֿױלן	ב אַ פֿ ױ ל נ
באַפֿאַלן	ב אַ פֿ אַ ל נ
באָב	ב אָ ב
באָבע	ב אָ ב ע
באָבעס	ב אָ ב ע ס
באָבעצע	ב אָ ב ע צ ע
באָבעשי	ב אָ ב ע ש י
באָד	ב אָ ד
באָדט	ב אָ ד ט
באָדן	ב אָ ד נ
באָדנדיק	ב אָ ד נ ד י ק
באָט	ב אָ ט
באָטל	ב אָ ט ל
באָטע־מידראָשים	ב אָ ט ע מ י ד ר אָ ש י מ
באָכער	ב אָ כ ע ר
באָכערל	ב אָ כ ע ר ל
באָכערװײַז	ב אָ כ ע ר װ ײַ ז
באָלװאַן	ב אָ ל װ אַ נ
באָמקעט	ב אָ מ ק ע ט
באָנטשע	ב אָ נ ט ש ע
באָנטשען	ב אָ נ ט ש ע נ
באָנטשעס	ב אָ נ ט ש ע ס
באָנים	ב אָ נ י מ
באָרגן	ב אָ ר ג נ
באָרד	ב אָ ר ד
באָרכאַשעם	ב אָ ר כ אַ ש ע מ
באָרעך	ב אָ ר ע כ
באָרעך־שעאָמער	ב אָ ר ע כ ש ע אָ מ ע ר
באָרעכס	ב אָ ר ע כ ס
באָרשט	ב אָ ר ש ט
באָרװעס	ב אָ ר װ ע ס
באָרװעסע	ב אָ ר װ ע ס ע
בפֿירושע	ב פֿ י ר ו ש ע
גגג	ג ג ג
גוזמע	ג ו ז מ ע
גוט	ג ו ט
גוט־יאָנטעװ	ג ו ט י אָ נ ט ע װ
גוט־יאָר	ג ו ט י אָ ר
גוט־מאָרגן	ג ו ט מ אָ ר ג נ
גוט־װאָך	ג ו ט װ אָ כ
גוט־װאָכס	ג ו ט װ אָ כ ס
גוטן	ג ו ט נ
גוטס	ג ו ט ס
גוטסקײט	ג ו ט ס ק ײ ט
גוטע	ג ו ט ע
גוטער	ג ו ט ע ר
גומענע	ג ו מ ע נ ע
גופֿע	ג ו פֿ ע
גזײלעס	ג ז ײ ל ע ס
גיב	ג י ב
גיב־מיר־נאָך	ג י ב מ י ר נ אָ כ
גיבן	ג י ב נ
גיבױרים	ג י ב ױ ר י מ
גיט	ג י ט
גיך	ג י כ
גיך־גיך	ג י כ ג י כ
גיכער	ג י כ ע ר
גיכקײט	ג י כ ק ײ ט
גילגולים	ג י ל ג ו ל י מ
גילגל	ג י ל ג ל
גילדן	ג י ל ד נ
גינגאָלד	ג י נ ג אָ ל ד
גינגאָלדענע	ג י נ ג אָ ל ד ע נ ע
גיס	ג י ס
גיסט	ג י ס ט
גיסן	ג י ס נ
גלוסט	ג ל ו ס ט
גלוסטן	ג ל ו ס ט נ
גלופּסק	ג ל ו פּ ס ק
גלופּסקער	ג ל ו פּ ס ק ע ר
גליד	ג ל י ד
גלידער	ג ל י ד ע ר
גליט	ג ל י ט
גליטש	ג ל י ט ש
גליטשט	ג ל י ט ש ט
גליטשיק	ג ל י ט ש י ק
גליצערינע	ג ל י צ ע ר י נ ע
גליק	ג ל י ק
גליקלעך	ג ל י ק ל ע כ
גליקלעכער	ג ל י ק ל ע כ ע ר
גליקן	ג ל י ק נ
גלעזל	ג ל ע ז ל
גלעזלעך	ג ל ע ז ל ע כ
גלעזעלע	ג ל ע ז ע ל ע
גלעזער	ג ל ע ז ע ר
גלעזערנע	ג ל ע ז ע ר נ ע
גלעזערנער	ג ל ע ז ע ר נ ע ר
גלעט	ג ל ע ט
גלעטנדיק	ג ל ע ט נ ד י ק
גלענצנדיקן	ג ל ע נ צ נ ד י ק נ
גלױב	ג ל ױ ב
גלױבט	ג ל ױ ב ט
גלױבן	ג ל ױ ב נ
גלײבט	ג ל ײ ב ט
גלײבן	ג ל ײ ב נ
גלײַך	ג ל ײַ כ
גלײַכגילטיק	ג ל ײַ כ ג י ל ט י ק
גלײַכן	ג ל ײַ כ נ
גלײַכע	ג ל ײַ כ ע
גלײַכער	ג ל ײַ כ ע ר
גלײַכװערטלעך	ג ל ײַ כ װ ע ר ט ל ע כ
גלאַט	ג ל אַ ט
גלאַנץ	ג ל אַ נ צ
גלאַנצט	ג ל אַ נ צ ט
גלאַנצן	ג ל אַ נ צ נ
גלאַנצנדיקן	ג ל אַ נ צ נ ד י ק נ
גלאַנצנדיקס	ג ל אַ נ צ נ ד י ק ס
גלאַנצעדיקן	ג ל אַ נ צ ע ד י ק נ
גלאָז	ג ל אָ ז
גלאָזל	ג ל אָ ז ל
גלאָק	ג ל אָ ק
גנײװעס	ג נ ײ װ ע ס
גנאָטעװען	ג נ אָ ט ע װ ע נ
געאײניקט	ג ע ײ נ י ק ט
געאײַלט	ג ע ײַ ל ט
געבונדן	ג ע ב ו נ ד נ
געביסן	ג ע ב י ס נ
געבליבן	ג ע ב ל י ב נ
געבליצט	ג ע ב ל י צ ט
געבלעטערט	ג ע ב ל ע ט ע ר ט
געבלאָזט	ג ע ב ל אָ ז ט
געבן	ג ע ב נ
געבנדיק	ג ע ב נ ד י ק
געבעט	ג ע ב ע ט
געבעטלט	ג ע ב ע ט ל ט
געבעטן	ג ע ב ע ט נ
געבענקט	ג ע ב ע נ ק ט
געבעקס	ג ע ב ע ק ס
געבעריעט	ג ע ב ע ר י ע ט
געבערקעס	ג ע ב ע ר ק ע ס
געברומט	ג ע ב ר ו מ ט
געברענט	ג ע ב ר ע נ ט
געבראַכט	ג ע ב ר אַ כ ט
געבראָטנס	ג ע ב ר אָ ט נ ס
געבראָטענע	ג ע ב ר אָ ט ע נ ע
געבױגט	ג ע ב ױ ג ט
געבױגן	ג ע ב ױ ג נ
געבױרן	ג ע ב ױ ר נ
געבײזער	ג ע ב ײ ז ע ר
געבאַקן	ג ע ב אַ ק נ
געגילטע	ג ע ג י ל ט ע
געגליכן	ג ע ג ל י כ נ
געגלעט	ג ע ג ל ע ט
געגלײבט	ג ע ג ל ײ ב ט
געגן	ג ע ג נ
געגנט	ג ע ג נ ט
געגעבן	ג ע ג ע ב נ
געגעט	ג ע ג ע ט
געגעסן	ג ע ג ע ס נ
געגריסט	ג ע ג ר י ס ט
געגרײט	ג ע ג ר ײ ט
געגאַנגען	ג ע ג אַ נ ג ע נ
געגאַנװעט	ג ע ג אַ נ װ ע ט
געגאָסן	ג ע ג אָ ס נ
געדולע	ג ע ד ו ל ע
געדיכטן	ג ע ד י כ ט נ
געדיכטע	ג ע ד י כ ט ע
געדיכטער	ג ע ד י כ ט ע ר
געדעכעניש	ג ע ד ע כ ע נ י ש
געדענק	ג ע ד ע נ ק
געדענקט	ג ע ד ע נ ק ט
געדענקען	ג ע ד ע נ ק ע נ
געדעקט	ג ע ד ע ק ט
געדערעם	ג ע ד ע ר ע מ
געדרונגען	ג ע ד ר ו נ ג ע נ
געדריקט	ג ע ד ר י ק ט
געדרײט	ג ע ד ר ײ ט
געדרײטע	ג ע ד ר ײ ט ע
געדאַכט	ג ע ד אַ כ ט
געדאַליע	ג ע ד אַ ל י ע
געדאַנק	ג ע ד אַ נ ק
געדאַנקט	ג ע ד אַ נ ק ט
געדאַנקען	ג ע ד אַ נ ק ע נ
געדאַװנט	ג ע ד אַ װ נ ט
געהוסט	ג ע ה ו ס ט
געהיט	ג ע ה י ט
געהילט	ג ע ה י ל ט
געהילץ	ג ע ה י ל צ
געהירן	ג ע ה י ר נ
געהענעם	ג ע ה ע נ ע מ
געהער	ג ע ה ע ר
געהערט	ג ע ה ע ר ט
געהערן	ג ע ה ע ר נ
געהױבן	ג ע ה ױ ב נ
געהױבענע	ג ע ה ױ ב ע נ ע
געהױכט	ג ע ה ױ כ ט
געהײמע	ג ע ה ײ מ ע
געהײמען	ג ע ה ײ מ ע נ
געהײסן	ג ע ה ײ ס נ
געהײצט	ג ע ה ײ צ ט
געהאַט	ג ע ה אַ ט
געהאַלטן	ג ע ה אַ ל ט נ
געהאַנדלט	ג ע ה אַ נ ד ל ט
געהאַקט	ג ע ה אַ ק ט
געהאַרגעט	ג ע ה אַ ר ג ע ט
געהאַרגעטנס	ג ע ה אַ ר ג ע ט נ ס
געהאָדעװעט	ג ע ה אָ ד ע װ ע ט
געהאָדעװעטע	ג ע ה אָ ד ע װ ע ט ע
געהאָלפֿן	ג ע ה אָ ל פֿ נ
געהאָנגען	ג ע ה אָ נ ג ע נ
געהאָרכט	ג ע ה אָ ר כ ט
געהאָפֿטענע	ג ע ה אָ פֿ ט ע נ ע
געזוכט	ג ע ז ו כ ט
געזונגען	ג ע ז ו נ ג ע נ
געזונט	ג ע ז ו נ ט
געזונטע	ג ע ז ו נ ט ע
געזונטער	ג ע ז ו נ ט ע ר
געזונטערהײט	ג ע ז ו נ ט ע ר ה ײ ט
געזונקען	ג ע ז ו נ ק ע נ
געזיכט	ג ע ז י כ ט
געזינדל	ג ע ז י נ ד ל
געזינטער	ג ע ז י נ ט ע ר
געזעגנט	ג ע ז ע ג נ ט
געזעלשאַפֿטלעכע	ג ע ז ע ל ש אַ פֿ ט ל ע כ ע
געזען	ג ע ז ע נ
געזעס	ג ע ז ע ס
געזעסן	ג ע ז ע ס נ
געזעצט	ג ע ז ע צ ט
געזױגן	ג ע ז ױ ג נ
געזאַלצן	ג ע ז אַ ל צ נ
געזאַנג	ג ע ז אַ נ ג
געזאַנגען	ג ע ז אַ נ ג ע נ
געזאָגט	ג ע ז אָ ג ט
געזאָלט	ג ע ז אָ ל ט
געטוליעט	ג ע ט ו ל י ע ט
געטון	ג ע ט ו נ
געטונקען	ג ע ט ו נ ק ע נ
געטוקט	ג ע ט ו ק ט
געטלעכע	ג ע ט ל ע כ ע
געטן	ג ע ט נ
געטרונקען	ג ע ט ר ו נ ק ע נ
געטריבן	ג ע ט ר י ב נ
געטריקנט	ג ע ט ר י ק נ ט
געטרערן	ג ע ט ר ע ר נ
געטרױ	ג ע ט ר ױ
געטרױסט	ג ע ט ר ױ ס ט
געטרײסלט	ג ע ט ר ײ ס ל ט
געטרײַער	ג ע ט ר ײַ ע ר
געטראַכט	ג ע ט ר אַ כ ט
געטראַנק	ג ע ט ר אַ נ ק
געטראַנקען	ג ע ט ר אַ נ ק ע נ
געטראָגן	ג ע ט ר אָ ג נ
געטראָפֿן	ג ע ט ר אָ פֿ נ
געטײלט	ג ע ט ײ ל ט
געטײַטלט	ג ע ט ײַ ט ל ט
געטײַנעט	ג ע ט ײַ נ ע ט
געטאָן	ג ע ט אָ נ
געיאָגט	ג ע י אָ ג ט
געכמאַרעט	ג ע כ מ אַ ר ע ט
געכאַזערט	ג ע כ אַ ז ע ר ט
געכאַפּט	ג ע כ אַ פּ ט
געכאָלעמט	ג ע כ אָ ל ע מ ט
געל	ג ע ל
געלבלעך	ג ע ל ב ל ע כ
געלט	ג ע ל ט
געליבט	ג ע ל י ב ט
געליבטן	ג ע ל י ב ט נ
געליבטע	ג ע ל י ב ט ע
געליטן	ג ע ל י ט נ
געלן	ג ע ל נ
געלע	ג ע ל ע
געלעבט	ג ע ל ע ב ט
געלעגן	ג ע ל ע ג נ
געלעגער	ג ע ל ע ג ע ר
געלעכטער	ג ע ל ע כ ט ע ר
געלעכטערל	ג ע ל ע כ ט ע ר ל
געלענקען	ג ע ל ע נ ק ע נ
געלעקט	ג ע ל ע ק ט
געלער	ג ע ל ע ר
געלערנט	ג ע ל ע ר נ ט
געלױבט	ג ע ל ױ ב ט
געלױכטן	ג ע ל ױ כ ט נ
געלױף	ג ע ל ױ פֿ
געלײגט	ג ע ל ײ ג ט
געלײמט	ג ע ל ײ מ ט
געלײענט	ג ע ל ײ ע נ ט
געלאַטעט	ג ע ל אַ ט ע ט
געלאַכט	ג ע ל אַ כ ט
געלאָזט	ג ע ל אָ ז ט
געלאָפֿן	ג ע ל אָ פֿ נ
געמוזט	ג ע מ ו ז ט
געמוטשעט	ג ע מ ו ט ש ע ט
געמורמל	ג ע מ ו ר מ ל
געמורמלט	ג ע מ ו ר מ ל ט
געמיט	ג ע מ י ט
געמיטן	ג ע מ י ט נ
געמינערט	ג ע מ י נ ע ר ט
געמישעכץ	ג ע מ י ש ע כ צ
געמעגט	ג ע מ ע ג ט
געמײנט	ג ע מ ײ נ ט
געמאַכט	ג ע מ אַ כ ט
געמאַכטע	ג ע מ אַ כ ט ע
געמאָלט	ג ע מ אָ ל ט
געמאָנט	ג ע מ אָ נ ט
געמאָסטן	ג ע מ אָ ס ט נ
געמאָרע	ג ע מ אָ ר ע
געמאָרע־ניגנדל	ג ע מ אָ ר ע נ י ג נ ד ל
געמאָרעס	ג ע מ אָ ר ע ס
גענדז	ג ע נ ד ז
גענדזנשמאַלץ	ג ע נ ד ז נ ש מ אַ ל צ
גענוג	ג ע נ ו ג
גענוגנדיקע	ג ע נ ו ג נ ד י ק ע
גענומען	ג ע נ ו מ ע נ
גענעענטערט	ג ע נ ע ע נ ט ע ר ט
גענאָגט	ג ע נ אָ ג ט
געסטרעכירט	ג ע ס ט ר ע כ י ר ט
געסטראַשעט	ג ע ס ט ר אַ ש ע ט
געסל	ג ע ס ל
געסלעך	ג ע ס ל ע כ
געסקריפּעט	ג ע ס ק ר י פּ ע ט
געסװיגן	ג ע ס װ י ג נ
געסאָפּעט	ג ע ס אָ פּ ע ט
געענדיקט	ג ע ע נ ד י ק ט
געענדערט	ג ע ע נ ד ע ר ט
געעפֿנט	ג ע ע פֿ נ ט
געצוקערט	ג ע צ ו ק ע ר ט
געצוקערטע	ג ע צ ו ק ע ר ט ע
געצװײפֿלט	ג ע צ װ ײ פֿ ל ט
געצװאָגן	ג ע צ װ אָ ג נ
געצױגן	ג ע צ ױ ג נ
געצײלט	ג ע צ ײ ל ט
געצאָלטס	ג ע צ אָ ל ט ס
געקומען	ג ע ק ו מ ע נ
געקוקט	ג ע ק ו ק ט
געקלונגען	ג ע ק ל ו נ ג ע נ
געקליבן	ג ע ק ל י ב נ
געקלערט	ג ע ק ל ע ר ט
געקלאַפּט	ג ע ק ל אַ פּ ט
געקלאָגט	ג ע ק ל אָ ג ט
געקנײטשט	ג ע ק נ ײ ט ש ט
געקנײטשטן	ג ע ק נ ײ ט ש ט נ
געקנײטשטע	ג ע ק נ ײ ט ש ט ע
געקנײטשטער	ג ע ק נ ײ ט ש ט ע ר
געקנײַפּט	ג ע ק נ ײַ פּ ט
געקנאַקט	ג ע ק נ אַ ק ט
געקענט	ג ע ק ע נ ט
געקעניגט	ג ע ק ע נ י ג ט
געקעצלט	ג ע ק ע צ ל ט
געקריגט	ג ע ק ר י ג ט
געקריגן	ג ע ק ר י ג נ
געקרעכצט	ג ע ק ר ע כ צ ט
געקרױנט	ג ע ק ר ױ נ ט
געקראַצט	ג ע ק ר אַ צ ט
געקראָכן	ג ע ק ר אָ כ נ
געקװיטשעט	ג ע ק װ י ט ש ע ט
געקױלעט	ג ע ק ױ ל ע ט
געקױפֿט	ג ע ק ױ פֿ ט
געקאַטשעט	ג ע ק אַ ט ש ע ט
געקאַרגט	ג ע ק אַ ר ג ט
געקאָכט	ג ע ק אָ כ ט
געקאָכטע	ג ע ק אָ כ ט ע
געקאָמאַנדעװעט	ג ע ק אָ מ אַ נ ד ע װ ע ט
געקאָנט	ג ע ק אָ נ ט
געקאָנטשעט	ג ע ק אָ נ ט ש ע ט
געקאָסט	ג ע ק אָ ס ט
גערודער	ג ע ר ו ד ע ר
גערוט	ג ע ר ו ט
גערונען	ג ע ר ו נ ע נ
גערוקט	ג ע ר ו ק ט
גערופֿן	ג ע ר ו פֿ נ
געריכט	ג ע ר י כ ט
געריסן	ג ע ר י ס נ
גערירט	ג ע ר י ר ט
גערן	ג ע ר נ
גערעדט	ג ע ר ע ד ט
גערעטעניש	ג ע ר ע ט ע נ י ש
גערעכט	ג ע ר ע כ ט
גערעכנט	ג ע ר ע כ נ ט
גערױש	ג ע ר ױ ש
גערױשט	ג ע ר ױ ש ט
גערײטלטע	ג ע ר ײ ט ל ט ע
גערײכערט	ג ע ר ײ כ ע ר ט
געראַטעװעטער	ג ע ר אַ ט ע װ ע ט ע ר
געראַשט	ג ע ר אַ ש ט
געראָטן	ג ע ר אָ ט נ
געראָטענע	ג ע ר אָ ט ע נ ע
געראָטענער	ג ע ר אָ ט ע נ ע ר
געשטופּט	ג ע ש ט ו פּ ט
געשטימט	ג ע ש ט י מ ט
געשטעלט	ג ע ש ט ע ל ט
געשטעקט	ג ע ש ט ע ק ט
געשטריקט	ג ע ש ט ר י ק ט
געשטרױכלט	ג ע ש ט ר ױ כ ל ט
געשטױסן	ג ע ש ט ױ ס נ
געשטאַלטן	ג ע ש ט אַ ל ט נ
געשטאַמלט	ג ע ש ט אַ מ ל ט
געשטאַנען	ג ע ש ט אַ נ ע נ
געשטאַנק	ג ע ש ט אַ נ ק
געשטאָכן	ג ע ש ט אָ כ נ
געשטאָרבן	ג ע ש ט אָ ר ב נ
געשיכטע	ג ע ש י כ ט ע
געשיקט	ג ע ש י ק ט
געשליפֿן	ג ע ש ל י פֿ נ
געשליפֿענע	ג ע ש ל י פֿ ע נ ע
געשלעג	ג ע ש ל ע ג
געשלעפּט	ג ע ש ל ע פּ ט
געשלאָפֿן	ג ע ש ל אָ פֿ נ
געשמועסט	ג ע ש מ ו ע ס ט
געשמועסן	ג ע ש מ ו ע ס נ
געשמיסן	ג ע ש מ י ס נ
געשמירט	ג ע ש מ י ר ט
געשמײכלט	ג ע ש מ ײ כ ל ט
געשמאַק	ג ע ש מ אַ ק
געשמאַקן	ג ע ש מ אַ ק נ
געשנײַצט	ג ע ש נ ײַ צ ט
געשעמט	ג ע ש ע מ ט
געשען	ג ע ש ע נ
געשענקט	ג ע ש ע נ ק ט
געשעצטעס	ג ע ש ע צ ט ע ס
געשעפֿט	ג ע ש ע פֿ ט
געשעפֿטן	ג ע ש ע פֿ ט נ
געשריבן	ג ע ש ר י ב נ
געשריגן	ג ע ש ר י ג נ
געשרײ	ג ע ש ר ײ
געשריִען	ג ע ש ר יִ ע נ
געשװיגן	ג ע ש װ י ג נ
געשװיצט	ג ע ש װ י צ ט
געשװעבט	ג ע ש װ ע ב ט
געשװױרן	ג ע ש װ ױ ר נ
געשװאָרן	ג ע ש װ אָ ר נ
געשײַנט	ג ע ש ײַ נ ט
געשאַט	ג ע ש אַ ט
געשאַלט	ג ע ש אַ ל ט
געשאָכטן	ג ע ש אָ כ ט נ
געשאָלטן	ג ע ש אָ ל ט נ
געשאָנקען	ג ע ש אָ נ ק ע נ
געשאָקלט	ג ע ש אָ ק ל ט
געשפּיגן	ג ע ש פּ י ג נ
געשפּילט	ג ע ש פּ י ל ט
געשפּרונגען	ג ע ש פּ ר ו נ ג ע נ
געשפּרעך	ג ע ש פּ ר ע כ
געשפּראָצט	ג ע ש פּ ר אָ צ ט
געשפּאַן	ג ע ש פּ אַ נ
געשפּאַנט	ג ע ש פּ אַ נ ט
געװ־	ג ע װ
געװיגט	ג ע װ י ג ט
געװיזן	ג ע װ י ז נ
געװיכט	ג ע װ י כ ט
געװינען	ג ע װ י נ ע נ
געװינקט	ג ע װ י נ ק ט
געװיס	ג ע װ י ס
געװיסער	ג ע װ י ס ע ר
געװישט	ג ע װ י ש ט
געװעזן	ג ע װ ע ז נ
געװעזענע	ג ע װ ע ז ע נ ע
געװעט	ג ע װ ע ט
געװעלבער	ג ע װ ע ל ב ע ר
געװען	ג ע װ ע נ
געװענדעט	ג ע װ ע נ ד ע ט
געװעקט	ג ע װ ע ק ט
געװױנהײט	ג ע װ ױ נ ה ײ ט
געװױנט	ג ע װ ױ נ ט
געװױר	ג ע װ ױ ר
געװױרע	ג ע װ ױ ר ע
געװײן	ג ע װ ײ נ
געװײנט	ג ע װ ײ נ ט
געװײנטלעך	ג ע װ ײ נ ט ל ע כ
געװײנלעך	ג ע װ ײ נ ל ע כ
געװײנלעכעס	ג ע װ ײ נ ל ע כ ע ס
געװאַגט	ג ע װ אַ ג ט
געװאַלגערט	ג ע װ אַ ל ג ע ר ט
געװאַלד	ג ע װ אַ ל ד
געװאַלדן	ג ע װ אַ ל ד נ
געװאַקסן	ג ע װ אַ ק ס נ
געװאַרט	ג ע װ אַ ר ט
געװאַשן	ג ע װ אַ ש נ
געװאָלט	ג ע װ אָ ל ט
געװאָר	ג ע װ אָ ר
געװאָרן	ג ע װ אָ ר נ
געװאָרפֿן	ג ע װ אָ ר פֿ נ
געװוּנדערט	ג ע װ וּ נ ד ע ר ט
געװוּסט	ג ע װ וּ ס ט
געאַרבעט	ג ע אַ ר ב ע ט
געאַרט	ג ע אַ ר ט
געאָרעמט	ג ע אָ ר ע מ ט
געפּילדערט	ג ע פּ י ל ד ע ר ט
געפּינעט	ג ע פּ י נ ע ט
געפּלאַצט	ג ע פּ ל אַ צ ט
געפּלאַפּלט	ג ע פּ ל אַ פּ ל ט
געפּרעגלט	ג ע פּ ר ע ג ל ט
געפּרעגלטע	ג ע פּ ר ע ג ל ט ע
געפּרעסט	ג ע פּ ר ע ס ט
געפּרוּװט	ג ע פּ ר וּ װ ט
געפּױעלט	ג ע פּ ױ ע ל ט
געפּײגערט	ג ע פּ ײ ג ע ר ט
געפּאַטערט	ג ע פּ אַ ט ע ר ט
געפּאַסט	ג ע פּ אַ ס ט
געפּאַסקנט	ג ע פּ אַ ס ק נ ט
געפֿונען	ג ע פֿ ו נ ע נ
געפֿיטערט	ג ע פֿ י ט ע ר ט
געפֿילט	ג ע פֿ י ל ט
געפֿין	ג ע פֿ י נ
געפֿינט	ג ע פֿ י נ ט
געפֿינען	ג ע פֿ י נ ע נ
געפֿירט	ג ע פֿ י ר ט
געפֿלױגן	ג ע פֿ ל ױ ג נ
געפֿלאָכטענער	ג ע פֿ ל אָ כ ט ע נ ע ר
געפֿעלט	ג ע פֿ ע ל ט
געפֿעלן	ג ע פֿ ע ל נ
געפֿעפֿערטע	ג ע פֿ ע פֿ ע ר ט ע
געפֿרעגט	ג ע פֿ ר ע ג ט
געפֿרױרן	ג ע פֿ ר ױ ר נ
געפֿרױרענע	ג ע פֿ ר ױ ר ע נ ע
געפֿרױרענער	ג ע פֿ ר ױ ר ע נ ע ר
געפֿרײט	ג ע פֿ ר ײ ט
געפֿײַפֿט	ג ע פֿ ײַ פֿ ט
געפֿאַלן	ג ע פֿ אַ ל נ
געפֿאַלענע	ג ע פֿ אַ ל ע נ ע
געפֿאָרן	ג ע פֿ אָ ר נ
גרוב	ג ר ו ב
גרונט	ג ר ו נ ט
גרוס	ג ר ו ס
גריבער	ג ר י ב ע ר
גריכנלאַנד	ג ר י כ נ ל אַ נ ד
גרימצאָרן	ג ר י מ צ אָ ר נ
גרין	ג ר י נ
גרינג	ג ר י נ ג
גרינגע	ג ר י נ ג ע
גרינגער	ג ר י נ ג ע ר
גרינינקע	ג ר י נ י נ ק ע
גרינלעך	ג ר י נ ל ע כ
גרינס	ג ר י נ ס
גרינע	ג ר י נ ע
גרינעם	ג ר י נ ע מ
גרינער	ג ר י נ ע ר
גרינערהײט	ג ר י נ ע ר ה ײ ט
גריסט	ג ר י ס ט
גריסן	ג ר י ס נ
גריװן	ג ר י װ נ
גריװן־גערוך	ג ר י װ נ ג ע ר ו כ
גרעזל	ג ר ע ז ל
גרעזלעכס	ג ר ע ז ל ע כ ס
גרעזעלע	ג ר ע ז ע ל ע
גרעזער	ג ר ע ז ע ר
גרעט	ג ר ע ט
גרעסטן	ג ר ע ס ט נ
גרעסטע	ג ר ע ס ט ע
גרעסטער	ג ר ע ס ט ע ר
גרעסער	ג ר ע ס ע ר
גרעסערן	ג ר ע ס ע ר נ
גרעסערע	ג ר ע ס ע ר ע
גרעסערער	ג ר ע ס ע ר ע ר
גרױ	ג ר ױ
גרױס	ג ר ױ ס
גרױסן	ג ר ױ ס נ
גרױסע	ג ר ױ ס ע
גרױסעס	ג ר ױ ס ע ס
גרױסער	ג ר ױ ס ע ר
גרױע	ג ר ױ ע
גרױען	ג ר ױ ע נ
גרױער	ג ר ױ ע ר
גרײט	ג ר ײ ט
גראַטעס	ג ר אַ ט ע ס
גראַף	ג ר אַ פֿ
גראַפֿן	ג ר אַ פֿ נ
גראָב	ג ר אָ ב
גראָבן	ג ר אָ ב נ
גראָבע	ג ר אָ ב ע
גראָבער	ג ר אָ ב ע ר
גראָד	ג ר אָ ד
גראָז	ג ר אָ ז
גראָס־אינקװיזיטאָרן	ג ר אָ ס י נ ק װ י ז י ט אָ ר נ
גראָשן	ג ר אָ ש נ
גװיר	ג װ י ר
גװירטע	ג װ י ר ט ע
גװאַלד	ג װ אַ ל ד
גװאַלדעװעט	ג װ אַ ל ד ע װ ע ט
גװאַרדיע	ג װ אַ ר ד י ע
גװוּרע	ג װ וּ ר ע
גױ	ג ױ
גױלעמס	ג ױ ל ע מ ס
גױסעסן	ג ױ ס ע ס נ
גױעס	ג ױ ע ס
גױיִשן	ג ױ יִ ש נ
גױיִשע	ג ױ יִ ש ע
גײ	ג ײ
גײט	ג ײ ט
גײן	ג ײ נ
גײען	ג ײ ע נ
גײענדיק	ג ײ ע נ ד י ק
גײַסט	ג ײַ ס ט
גײַװע	ג ײַ װ ע
גאַבע	ג אַ ב ע
גאַבעטע	ג אַ ב ע ט ע
גאַבעס	ג אַ ב ע ס
גאַבאָיִם	ג אַ ב אָ יִ מ
גאַדלע	ג אַ ד ל ע
גאַזלעװױע	ג אַ ז ל ע װ ױ ע
גאַזשע	ג אַ ז ש ע
גאַל	ג אַ ל
גאַליאַסײנו	ג אַ ל י אַ ס ײ נ ו
גאַלעכס	ג אַ ל ע כ ס
גאַנג	ג אַ נ ג
גאַנדז	ג אַ נ ד ז
גאַנעװ	ג אַ נ ע װ
גאַנץ	ג אַ נ צ
גאַנצן	ג אַ נ צ נ
גאַנצע	ג אַ נ צ ע
גאַנצער	ג אַ נ צ ע ר
גאַנװעט	ג אַ נ װ ע ט
גאַנװענען	ג אַ נ װ ע נ ע נ
גאַנײדן	ג אַ נ ײ ד נ
גאַנײװישע	ג אַ נ ײ װ י ש ע
גאַנײװע	ג אַ נ ײ װ ע
גאַנאָװים	ג אַ נ אָ װ י מ
גאַס	ג אַ ס
גאַס־אױס	ג אַ ס ױ ס
גאַס־אײן	ג אַ ס ײ נ
גאַסט	ג אַ ס ט
גאַסטהױז	ג אַ ס ט ה ױ ז
גאַסן	ג אַ ס נ
גאַרדינען	ג אַ ר ד י נ ע נ
גאַרטל	ג אַ ר ט ל
גאַרטלען	ג אַ ר ט ל ע נ
גאַװריִעל	ג אַ װ ר יִ ע ל
גאָדאָל	ג אָ ד אָ ל
גאָט	ג אָ ט
גאָטס	ג אָ ט ס
גאָטעס	ג אָ ט ע ס
גאָטעסדינסט	ג אָ ט ע ס ד י נ ס ט
גאָלד	ג אָ ל ד
גאָלדע	ג אָ ל ד ע
גאָלדעלע	ג אָ ל ד ע ל ע
גאָלדען	ג אָ ל ד ע נ
גאָלדענע	ג אָ ל ד ע נ ע
גאָלדענעם	ג אָ ל ד ע נ ע מ
גאָלדענער	ג אָ ל ד ע נ ע ר
גאָלדעס	ג אָ ל ד ע ס
גאָלדשמיד	ג אָ ל ד ש מ י ד
גאָלי	ג אָ ל י
גאָליש־עפּעלעך	ג אָ ל י ש ע פּ ע ל ע כ
גאָלע	ג אָ ל ע
גאָלעס	ג אָ ל ע ס
גאָמבין	ג אָ מ ב י נ
גאָמבינער	ג אָ מ ב י נ ע ר
גאָמבינערס	ג אָ מ ב י נ ע ר ס
גאָמבע	ג אָ מ ב ע
גאָס	ג אָ ס
גאָר	ג אָ ר
גאָרטן	ג אָ ר ט נ
גאָרניט	ג אָ ר נ י ט
גאָרנישט	ג אָ ר נ י ש ט
גאָיִם	ג אָ יִ מ
גאָיִש	ג אָ יִ ש
גאָאָאָאָאָט	ג אָ אָ אָ אָ אָ ט
גאָפּל	ג אָ פּ ל
גאָפּלען	ג אָ פּ ל ע נ
דו	ד ו
דולן	ד ו ל נ
דולער	ד ו ל ע ר
דונער	ד ו נ ע ר
דוצט	ד ו צ ט
דורך	ד ו ר כ
דורכגעטריבענע	ד ו ר כ ג ע ט ר י ב ע נ ע
דורכגעשװעבט	ד ו ר כ ג ע ש װ ע ב ט
דורכגעשװענקט	ד ו ר כ ג ע ש װ ע נ ק ט
דורכגעפֿירט	ד ו ר כ ג ע פֿ י ר ט
דורכגעפֿלױגן	ד ו ר כ ג ע פֿ ל ױ ג נ
דורכגײן	ד ו ר כ ג ײ נ
דורכגײענדיק	ד ו ר כ ג ײ ע נ ד י ק
דורכגײער	ד ו ר כ ג ײ ע ר
דורכזיכטיק	ד ו ר כ ז י כ ט י ק
דורכלאָזן	ד ו ר כ ל אָ ז נ
דורכן	ד ו ר כ נ
דורכרײַזנדיק	ד ו ר כ ר ײַ ז נ ד י ק
דורכשלאָג	ד ו ר כ ש ל אָ ג
דורכפֿאָרן	ד ו ר כ פֿ אָ ר נ
די	ד י
דיבורים	ד י ב ו ר י מ
דיבער	ד י ב ע ר
דיך	ד י כ
דימענט	ד י מ ע נ ט
דין	ד י נ
דין־יונג	ד י נ י ו נ ג
דין־װעכעזשבם	ד י נ װ ע כ ע ז ש ב מ
דינגט	ד י נ ג ט
דינגען	ד י נ ג ע נ
דיני	ד י נ י
דיניטשקע	ד י נ י ט ש ק ע
דיניס	ד י נ י ס
דינסט	ד י נ ס ט
דינסטמײדל	ד י נ ס ט מ ײ ד ל
דינסטן	ד י נ ס ט נ
דינסטס	ד י נ ס ט ס
דינע	ד י נ ע
דינעם	ד י נ ע מ
דיעלע	ד י ע ל ע
דיק	ד י ק
דיקדעק	ד י ק ד ע ק
דיקן	ד י ק נ
דיקסי	ד י ק ס י
דיקע	ד י ק ע
דיקער	ד י ק ע ר
דיר	ד י ר
דירע	ד י ר ע
דישל	ד י ש ל
דעהײַנע	ד ע ה ײַ נ ע
דעי	ד ע י
דעכל	ד ע כ ל
דעכער	ד ע כ ע ר
דעליקטו	ד ע ל י ק ט ו
דעם	ד ע מ
דעמאָלט	ד ע מ אָ ל ט
דען	ד ע נ
דענסטמאָל	ד ע נ ס ט מ אָ ל
דענצמאָל	ד ע נ צ מ אָ ל
דענצמאָלדיקע	ד ע נ צ מ אָ ל ד י ק ע
דענק	ד ע נ ק
דעסט	ד ע ס ט
דעק	ד ע ק
דעקט	ד ע ק ט
דעקלאַמירט	ד ע ק ל אַ מ י ר ט
דעקן	ד ע ק נ
דעקע	ד ע ק ע
דער	ד ע ר
דער־	ד ע ר
דערבײַ	ד ע ר ב ײַ
דערבאַרעמען	ד ע ר ב אַ ר ע מ ע נ
דערגיס	ד ע ר ג י ס
דערגיסט	ד ע ר ג י ס ט
דערגרונטעװען	ד ע ר ג ר ו נ ט ע װ ע נ
דערגרײכן	ד ע ר ג ר ײ כ נ
דערגײט	ד ע ר ג ײ ט
דערגײן	ד ע ר ג ײ נ
דערגאַנגען	ד ע ר ג אַ נ ג ע נ
דערהער	ד ע ר ה ע ר
דערהערט	ד ע ר ה ע ר ט
דערהערנדיק	ד ע ר ה ע ר נ ד י ק
דערהױבט	ד ע ר ה ױ ב ט
דערהױבן	ד ע ר ה ױ ב נ
דערהאַרגעט	ד ע ר ה אַ ר ג ע ט
דערונטער	ד ע ר ו נ ט ע ר
דערזע	ד ע ר ז ע
דערזעט	ד ע ר ז ע ט
דערזען	ד ע ר ז ע נ
דערזעענדיק	ד ע ר ז ע ע נ ד י ק
דערטרינקעניש	ד ע ר ט ר י נ ק ע נ י ש
דערטאַפּט	ד ע ר ט אַ פּ ט
דעריבער	ד ע ר י ב ע ר
דערינען	ד ע ר י נ ע נ
דערלעבט	ד ע ר ל ע ב ט
דערלעבן	ד ע ר ל ע ב נ
דערלױבן	ד ע ר ל ױ ב נ
דערלײג	ד ע ר ל ײ ג
דערלײגט	ד ע ר ל ײ ג ט
דערלײזונג	ד ע ר ל ײ ז ו נ ג
דערלאַנגט	ד ע ר ל אַ נ ג ט
דערלאַנגען	ד ע ר ל אַ נ ג ע נ
דערלאַנגענדיק	ד ע ר ל אַ נ ג ע נ ד י ק
דערלאָזט	ד ע ר ל אָ ז ט
דערלאָזן	ד ע ר ל אָ ז נ
דערמיט	ד ע ר מ י ט
דערמאַנען	ד ע ר מ אַ נ ע נ
דערמאָן	ד ע ר מ אָ נ
דערמאָנט	ד ע ר מ אָ נ ט
דערמאָנען	ד ע ר מ אָ נ ע נ
דערנערט	ד ע ר נ ע ר ט
דערנאָך	ד ע ר נ אָ כ
דערעכערעץ	ד ע ר ע כ ע ר ע צ
דערעכערעצדיקער	ד ע ר ע כ ע ר ע צ ד י ק ע ר
דערצו	ד ע ר צ ו
דערציטערטער	ד ע ר צ י ט ע ר ט ע ר
דערצײל	ד ע ר צ ײ ל
דערצײלונגען	ד ע ר צ ײ ל ו נ ג ע נ
דערצײלט	ד ע ר צ ײ ל ט
דערצײלן	ד ע ר צ ײ ל נ
דערקוטשען	ד ע ר ק ו ט ש ע נ
דערקלער	ד ע ר ק ל ע ר
דערקלערט	ד ע ר ק ל ע ר ט
דערקען	ד ע ר ק ע נ
דערקענט	ד ע ר ק ע נ ט
דערקענען	ד ע ר ק ע נ ע נ
דערקװיקעניש	ד ע ר ק װ י ק ע נ י ש
דערקאָנט	ד ע ר ק אָ נ ט
דערשטיקט	ד ע ר ש ט י ק ט
דערשלאָגן	ד ע ר ש ל אָ ג נ
דערשמעקט	ד ע ר ש מ ע ק ט
דערשרעקט	ד ע ר ש ר ע ק ט
דערשראָקן	ד ע ר ש ר אָ ק נ
דערשראָקענע	ד ע ר ש ר אָ ק ע נ ע
דערשראָקענער	ד ע ר ש ר אָ ק ע נ ע ר
דערװיסן	ד ע ר װ י ס נ
דערװעקט	ד ע ר װ ע ק ט
דערװײַטערט	ד ע ר װ ײַ ט ע ר ט
דערװײַל	ד ע ר װ ײַ ל
דערװײַלע	ד ע ר װ ײַ ל ע
דערװאַקסענע	ד ע ר װ אַ ק ס ע נ ע
דערװאַקסענעם	ד ע ר װ אַ ק ס ע נ ע מ
דערװאָרגן	ד ע ר װ אָ ר ג נ
דערװוּסט	ד ע ר װ וּ ס ט
דערױף	ד ע ר ױ פֿ
דערפֿון	ד ע ר פֿ ו נ
דערפֿילט	ד ע ר פֿ י ל ט
דערפֿילן	ד ע ר פֿ י ל נ
דערפֿרישן	ד ע ר פֿ ר י ש נ
דערפֿאַר	ד ע ר פֿ אַ ר
דר'ערד	ד ר ע ר ד
דרוק	ד ר ו ק
דריטל	ד ר י ט ל
דריטן	ד ר י ט נ
דריטע	ד ר י ט ע
דריטער	ד ר י ט ע ר
דרימלען	ד ר י מ ל ע נ
דרינגט	ד ר י נ ג ט
דרינגען	ד ר י נ ג ע נ
דרינען	ד ר י נ ע נ
דריקט	ד ר י ק ט
דריקן	ד ר י ק נ
דרעמלט	ד ר ע מ ל ט
דרעמלען	ד ר ע מ ל ע נ
דרױסן	ד ר ױ ס נ
דרײ	ד ר ײ
דרײדל	ד ר ײ ד ל
דרײט	ד ר ײ ט
דרײסט	ד ר ײ ס ט
דרײסטער	ד ר ײ ס ט ע ר
דרײען	ד ר ײ ע נ
דרײער	ד ר ײ ע ר
דרײַ	ד ר ײַ
דרײַסיק	ד ר ײַ ס י ק
דרײַסיק־פֿערציק	ד ר ײַ ס י ק פֿ ע ר צ י ק
דרײַער	ד ר ײַ ע ר
דרײַצן	ד ר ײַ צ נ
דרײַצנטער	ד ר ײַ צ נ ט ע ר
דראַמען־שרײַבער	ד ר אַ מ ע נ ש ר ײַ ב ע ר
דראַמאַטישער	ד ר אַ מ אַ ט י ש ע ר
דראַפּעט	ד ר אַ פּ ע ט
דראָט־אַרבעטנדיקע	ד ר אָ ט אַ ר ב ע ט נ ד י ק ע
דראָנג	ד ר אָ נ ג
דראָשע	ד ר אָ ש ע
דראָשעס	ד ר אָ ש ע ס
דראָשקעס	ד ר אָ ש ק ע ס
דװאָריעץ	ד װ אָ ר י ע צ
דױערן	ד ױ ע ר נ
דױרעס	ד ױ ר ע ס
דױפֿעק	ד ױ פֿ ע ק
דײזשע	ד ײ ז ש ע
דײע	ד ײ ע
דײַגע	ד ײַ ג ע
דײַטש	ד ײַ ט ש
דײַטשיש	ד ײַ ט ש י ש
דײַטשל	ד ײַ ט ש ל
דײַטשלס	ד ײַ ט ש ל ס
דײַטשמעריש	ד ײַ ט ש מ ע ר י ש
דײַטשן	ד ײַ ט ש נ
דײַן	ד ײַ נ
דײַנע	ד ײַ נ ע
דײַנעם	ד ײַ נ ע מ
דײַעט	ד ײַ ע ט
דאַבער	ד אַ ב ע ר
דאַטשע	ד אַ ט ש ע
דאַיאָנים	ד אַ י אָ נ י מ
דאַך	ד אַ כ
דאַכט	ד אַ כ ט
דאַכטן	ד אַ כ ט נ
דאַן	ד אַ נ
דאַנען	ד אַ נ ע נ
דאַנציק	ד אַ נ צ י ק
דאַנק	ד אַ נ ק
דאַנקבאַרקײט	ד אַ נ ק ב אַ ר ק ײ ט
דאַנקט	ד אַ נ ק ט
דאַנקען	ד אַ נ ק ע נ
דאַר	ד אַ ר
דאַרן	ד אַ ר נ
דאַרס	ד אַ ר ס
דאַרע	ד אַ ר ע
דאַרער	ד אַ ר ע ר
דאַרף	ד אַ ר פֿ
דאַרױס	ד אַ ר ױ ס
דאַרפֿט	ד אַ ר פֿ ט
דאַרפֿן	ד אַ ר פֿ נ
דאַרפֿסטו	ד אַ ר פֿ ס ט ו
דאַשעק	ד אַ ש ע ק
דאַשעקל	ד אַ ש ע ק ל
דאַװן	ד אַ װ נ
דאַװנט	ד אַ װ נ ט
דאַװנען	ד אַ װ נ ע נ
דאַװענען	ד אַ װ ע נ ע נ
דאַװקע	ד אַ װ ק ע
דאָ	ד אָ
דאָבציע	ד אָ ב צ י ע
דאָבציען	ד אָ ב צ י ע נ
דאָזיקן	ד אָ ז י ק נ
דאָזיקע	ד אָ ז י ק ע
דאָזיקער	ד אָ ז י ק ע ר
דאָזאָר	ד אָ ז אָ ר
דאָך	ד אָ כ
דאָנערשטיק	ד אָ נ ע ר ש ט י ק
דאָס	ד אָ ס
דאָקטער	ד אָ ק ט ע ר
דאָקטערס	ד אָ ק ט ע ר ס
דאָקטױרים	ד אָ ק ט ױ ר י מ
דאָקטאָר	ד אָ ק ט אָ ר
דאָר	ד אָ ר
דאָר־	ד אָ ר
דאָרט	ד אָ ר ט
דאָרטן	ד אָ ר ט נ
דאָרף	ד אָ ר פֿ
דאָרפֿישן	ד אָ ר פֿ י ש נ
דאָװיד	ד אָ װ י ד
דאָװידל	ד אָ װ י ד ל
דאָװידלען	ד אָ װ י ד ל ע נ
דאָװער	ד אָ װ ע ר
הו־האַ	ה ו ה אַ
הוט	ה ו ט
הולטײַ	ה ו ל ט ײַ
הומאַניטאַרע	ה ו מ אַ נ י ט אַ ר ע
הון	ה ו נ
הונגער	ה ו נ ג ע ר
הונגעריק	ה ו נ ג ע ר י ק
הונגערן	ה ו נ ג ע ר נ
הונדערט	ה ו נ ד ע ר ט
הונדערט־פּראָצענטיקער	ה ו נ ד ע ר ט פּ ר אָ צ ע נ ט י ק ע ר
הונדערטער	ה ו נ ד ע ר ט ע ר
הונט	ה ו נ ט
הוסט	ה ו ס ט
הוסטן	ה ו ס ט נ
הורטאָװניקעס	ה ו ר ט אָ װ נ י ק ע ס
הוראַ	ה ו ר אַ
היגע	ה י ג ע
היטל	ה י ט ל
היטלעך	ה י ט ל ע כ
היטלען	ה י ט ל ע נ
היטן	ה י ט נ
היטעלע	ה י ט ע ל ע
היטעלעך	ה י ט ע ל ע כ
היכ־	ה י כ
הילן	ה י ל נ
הילף	ה י ל פֿ
הילצערנע	ה י ל צ ע ר נ ע
הימל	ה י מ ל
הימלישע	ה י מ ל י ש ע
הימלען	ה י מ ל ע נ
הימעל־פֿאָטער	ה י מ ע ל פֿ אָ ט ע ר
הינדל	ה י נ ד ל
הינדעלע	ה י נ ד ע ל ע
הינט	ה י נ ט
הינטישע	ה י נ ט י ש ע
הינטן	ה י נ ט נ
הינטעלעך	ה י נ ט ע ל ע כ
הינטער	ה י נ ט ע ר
הינטער־געסלעך	ה י נ ט ע ר ג ע ס ל ע כ
הינטער־קעשענע	ה י נ ט ע ר ק ע ש ע נ ע
הינטערגעסל	ה י נ ט ע ר ג ע ס ל
הינטערן	ה י נ ט ע ר נ
הינטערשטער	ה י נ ט ע ר ש ט ע ר
הינער	ה י נ ע ר
היספּײַלעס	ה י ס פּ ײַ ל ע ס
היץ	ה י צ
הירשנבײן	ה י ר ש נ ב ײ נ
היװדאַלטאָ	ה י װ ד אַ ל ט אָ
היװדאַלעװען	ה י װ ד אַ ל ע װ ע נ
היפּשע	ה י פּ ש ע
המנס	ה מ נ ס
העגדעש	ה ע ג ד ע ש
העדרעס	ה ע ד ר ע ס
העט־העט	ה ע ט ה ע ט
העכט	ה ע כ ט
העכסט	ה ע כ ס ט
העכסטנס	ה ע כ ס ט נ ס
העכער	ה ע כ ע ר
העכערן	ה ע כ ע ר נ
העכערע	ה ע כ ע ר ע
העל	ה ע ל
העל־רױז	ה ע ל ר ױ ז
העל־רױטלעך־בלױ־טונקל־גרין־פּאָפּעליאַטע	ה ע ל ר ױ ט ל ע כ ב ל ױ ט ו נ ק ל ג ר י נ פּ אָ פּ ע ל י אַ ט ע
העלדזל	ה ע ל ד ז ל
העלדזער	ה ע ל ד ז ע ר
העליש	ה ע ל י ש
העלן	ה ע ל נ
העלף	ה ע ל פֿ
העלצלעך	ה ע ל צ ל ע כ
העלפֿט	ה ע ל פֿ ט
העלפֿן	ה ע ל פֿ נ
העלפֿנדיק	ה ע ל פֿ נ ד י ק
העם	ה ע מ
העמד	ה ע מ ד
העמדל	ה ע מ ד ל
הענגט	ה ע נ ג ט
הענגען	ה ע נ ג ע נ
הענגערל	ה ע נ ג ע ר ל
הענגקאָלנער	ה ע נ ג ק אָ ל נ ע ר
הענדום־פּענדום	ה ע נ ד ו מ פּ ע נ ד ו מ
הענדל	ה ע נ ד ל
הענדלס	ה ע נ ד ל ס
הענדלען	ה ע נ ד ל ע נ
הענט	ה ע נ ט
הענטל	ה ע נ ט ל
הענטלעך	ה ע נ ט ל ע כ
הענעך	ה ע נ ע כ
הענרי	ה ע נ ר י
העסעבעט	ה ע ס ע ב ע ט
העק	ה ע ק
העקער	ה ע ק ע ר
העקערס	ה ע ק ע ר ס
הער	ה ע ר
הערט	ה ע ר ט
הערינג	ה ע ר י נ ג
הערלעכע	ה ע ר ל ע כ ע
הערן	ה ע ר נ
הערנדיק	ה ע ר נ ד י ק
הערנער	ה ע ר נ ע ר
הערסט	ה ע ר ס ט
הערסטו	ה ע ר ס ט ו
הערצל	ה ע ר צ ל
הערצלעכן	ה ע ר צ ל ע כ נ
הערצער	ה ע ר צ ע ר
הערש־בער	ה ע ר ש ב ע ר
הערשל	ה ע ר ש ל
העראָט	ה ע ר אָ ט
העפֿט	ה ע פֿ ט
העפֿטן	ה ע פֿ ט נ
הרובע	ה ר ו ב ע
הױב	ה ױ ב
הױבט	ה ױ ב ט
הױבן	ה ױ ב נ
הױדלקע	ה ױ ד ל ק ע
הױדעט	ה ױ ד ע ט
הױדען	ה ױ ד ע נ
הױז	ה ױ ז
הױזגעזינד	ה ױ ז ג ע ז י נ ד
הױזגעזינדן	ה ױ ז ג ע ז י נ ד נ
הױזל	ה ױ ז ל
הױזלעך	ה ױ ז ל ע כ
הױזן	ה ױ ז נ
הױזן־קעשענע	ה ױ ז נ ק ע ש ע נ ע
הױט	ה ױ ט
הױך	ה ױ כ
הױכן	ה ױ כ נ
הױכע	ה ױ כ ע
הױכער	ה ױ כ ע ר
הױלע	ה ױ ל ע
הױף	ה ױ פֿ
הױצאָעס	ה ױ צ אָ ע ס
הױקער	ה ױ ק ע ר
הױראָע	ה ױ ר אָ ע
הױפּטדאַמע	ה ױ פּ ט ד אַ מ ע
הױפֿדאַמע	ה ױ פֿ ד אַ מ ע
הױפֿן	ה ױ פֿ נ
הױפֿנס	ה ױ פֿ נ ס
הױפֿװעכטער	ה ױ פֿ װ ע כ ט ע ר
הײ	ה ײ
הײב	ה ײ ב
הײבט	ה ײ ב ט
הײבן	ה ײ ב נ
הײזלעך	ה ײ ז ל ע כ
הײזעריק	ה ײ ז ע ר י ק
הײזעריקן	ה ײ ז ע ר י ק נ
הײזעריקע	ה ײ ז ע ר י ק ע
הײל	ה ײ ל
הײלט	ה ײ ל ט
הײליקן	ה ײ ל י ק נ
הײליקער	ה ײ ל י ק ע ר
הײלן	ה ײ ל נ
הײם	ה ײ מ
הײמיש	ה ײ מ י ש
הײמישן	ה ײ מ י ש נ
הײמישע	ה ײ מ י ש ע
הײמישער	ה ײ מ י ש ע ר
הײמישקײט	ה ײ מ י ש ק ײ ט
הײס	ה ײ ס
הײס־אָנגעזענגטע	ה ײ ס אָ נ ג ע ז ע נ ג ט ע
הײסט	ה ײ ס ט
הײסן	ה ײ ס נ
הײסע	ה ײ ס ע
הײסער	ה ײ ס ע ר
הײװן	ה ײ װ נ
הײַדאַ	ה ײַ ד אַ
הײַזל	ה ײַ ז ל
הײַזלעך	ה ײַ ז ל ע כ
הײַזער	ה ײַ ז ע ר
הײַטל	ה ײַ ט ל
הײַליק	ה ײַ ל י ק
הײַליקע	ה ײַ ל י ק ע
הײַנט	ה ײַ נ ט
הײַנטיקן	ה ײַ נ ט י ק נ
הײַנטיקס	ה ײַ נ ט י ק ס
הײַנטיקע	ה ײַ נ ט י ק ע
הײַנטיקער	ה ײַ נ ט י ק ע ר
הײַנטמאָדיש	ה ײַ נ ט מ אָ ד י ש
האַ	ה אַ
האַבעהײמע	ה אַ ב ע ה ײ מ ע
האַגיבער	ה אַ ג י ב ע ר
האַגאָדל	ה אַ ג אָ ד ל
האַגאָדע	ה אַ ג אָ ד ע
האַדרעס	ה אַ ד ר ע ס
האַדראַס	ה אַ ד ר אַ ס
האַו	ה אַ ו
האַיױם	ה אַ י ױ מ
האַכנאָסע	ה אַ כ נ אָ ס ע
האַכנאָסעס־אָרכים	ה אַ כ נ אָ ס ע ס אָ ר כ י מ
האַכנאָע	ה אַ כ נ אָ ע
האַכאָנעס	ה אַ כ אָ נ ע ס
האַלב	ה אַ ל ב
האַלב־געפֿרױרענעם	ה אַ ל ב ג ע פֿ ר ױ ר ע נ ע מ
האַלב־ליטװישן	ה אַ ל ב ל י ט װ י ש נ
האַלב־נאַקעטע	ה אַ ל ב נ אַ ק ע ט ע
האַלב־פֿאַרשלאָסענע	ה אַ ל ב פֿ אַ ר ש ל אָ ס ע נ ע
האַלבלעך	ה אַ ל ב ל ע כ
האַלבן	ה אַ ל ב נ
האַלבע	ה אַ ל ב ע
האַלבער	ה אַ ל ב ע ר
האַלדז	ה אַ ל ד ז
האַלדזטיכל	ה אַ ל ד ז ט י כ ל
האַלדזן	ה אַ ל ד ז נ
האַלט	ה אַ ל ט
האַלטן	ה אַ ל ט נ
האַלטנדיק	ה אַ ל ט נ ד י ק
האַלטסט	ה אַ ל ט ס ט
האַלטסטו	ה אַ ל ט ס ט ו
האַלעלוּיאָ	ה אַ ל ע ל וּ י אָ
האַלעלוּיאָס	ה אַ ל ע ל וּ י אָ ס
האַמצאָע	ה אַ מ צ אָ ע
האַמױצע	ה אַ מ ױ צ ע
האַמײלעך	ה אַ מ ײ ל ע כ
האַמײַסע	ה אַ מ ײַ ס ע
האַמאַװדיל	ה אַ מ אַ װ ד י ל
האַמאַאַריװ	ה אַ מ אַ אַ ר י װ
האַנדל	ה אַ נ ד ל
האַנדלט	ה אַ נ ד ל ט
האַנדלען	ה אַ נ ד ל ע נ
האַנט	ה אַ נ ט
האַנטגעלט	ה אַ נ ט ג ע ל ט
האַנאָע	ה אַ נ אָ ע
האַנאָװעס	ה אַ נ אָ װ ע ס
האַס	ה אַ ס
האַסמאָדע	ה אַ ס מ אָ ד ע
האַסקאָלע	ה אַ ס ק אָ ל ע
האַסקאָמע	ה אַ ס ק אָ מ ע
האַסאָגע	ה אַ ס אָ ג ע
האַק	ה אַ ק
האַקט	ה אַ ק ט
האַקלאַל	ה אַ ק ל אַ ל
האַקן	ה אַ ק נ
האַקאָדעש־באָרכו	ה אַ ק אָ ד ע ש ב אָ ר כ ו
האַקאָפֿעס	ה אַ ק אָ פֿ ע ס
האַרבן	ה אַ ר ב נ
האַרגעט	ה אַ ר ג ע ט
האַרוגים	ה אַ ר ו ג י מ
האַרט	ה אַ ר ט
האַרטן	ה אַ ר ט נ
האַרטע	ה אַ ר ט ע
האַרטער	ה אַ ר ט ע ר
האַריגעס	ה אַ ר י ג ע ס
האַרמידער	ה אַ ר מ י ד ע ר
האַרמאַט	ה אַ ר מ אַ ט
האַרמאָניע	ה אַ ר מ אָ נ י ע
האַרץ	ה אַ ר צ
האַרץ־ברעטלעך	ה אַ ר צ ב ר ע ט ל ע כ
האַרץ־נאָגנדע	ה אַ ר צ נ אָ ג נ ד ע
האַרץ־סטרונעס	ה אַ ר צ ס ט ר ו נ ע ס
האַרץ־קלאַפּן	ה אַ ר צ ק ל אַ פּ נ
האַרץ־רײַסנדיקער	ה אַ ר צ ר ײַ ס נ ד י ק ע ר
האַרציק	ה אַ ר צ י ק
האַרצן	ה אַ ר צ נ
האַרפּע	ה אַ ר פּ ע
האַשעם־ייִסבאָרעך	ה אַ ש ע מ י יִ ס ב אָ ר ע כ
האַשװיִיִ	ה אַ ש װ יִ יִ
האַװדאָ־	ה אַ װ ד אָ
האַװדאָלע	ה אַ װ ד אָ ל ע
האַװדאָלע־װײַן	ה אַ װ ד אָ ל ע װ ײַ נ
האַױלעם	ה אַ ױ ל ע מ
האַיִטאָכן	ה אַ יִ ט אָ כ נ
האָב	ה אָ ב
האָבן	ה אָ ב נ
האָבער	ה אָ ב ע ר
האָבער־קינדער	ה אָ ב ע ר ק י נ ד ע ר
האָדעװע	ה אָ ד ע װ ע
האָדעװעט	ה אָ ד ע װ ע ט
האָדעװען	ה אָ ד ע װ ע נ
האָזע	ה אָ ז ע
האָט	ה אָ ט
האָט'ן	ה אָ ט נ
האָטס	ה אָ ט ס
האָטעל	ה אָ ט ע ל
האָלץ	ה אָ ל צ
האָלץ־האַקן	ה אָ ל צ ה אַ ק נ
האָלצגעשעפֿט	ה אָ ל צ ג ע ש ע פֿ ט
האָן	ה אָ נ
האָניק	ה אָ נ י ק
האָנאָר	ה אָ נ אָ ר
האָנאָריסטע	ה אָ נ אָ ר י ס ט ע
האָנאָרעיבל	ה אָ נ אָ ר ע י ב ל
האָסט	ה אָ ס ט
האָסטו	ה אָ ס ט ו
האָסעניצע	ה אָ ס ע נ י צ ע
האָסעניצעס	ה אָ ס ע נ י צ ע ס
האָקעס	ה אָ ק ע ס
האָר	ה אָ ר
האָריזאָנט	ה אָ ר י ז אָ נ ט
האָרכט	ה אָ ר כ ט
האָרכן	ה אָ ר כ נ
האָרנשטײנס	ה אָ ר נ ש ט ײ נ ס
האָרעװעט	ה אָ ר ע װ ע ט
האָרעװען	ה אָ ר ע װ ע נ
האָרעפּאַשנעם	ה אָ ר ע פּ אַ ש נ ע מ
האָרפֿלאַקס	ה אָ ר פֿ ל אַ ק ס
האָײץ	ה אָ ײ צ
האָפּ	ה אָ פּ
האָפּן	ה אָ פּ נ
האָפֿן	ה אָ פֿ נ
האָפֿענונג	ה אָ פֿ ע נ ו נ ג
האָפֿערדיק	ה אָ פֿ ע ר ד י ק
זגולע	ז ג ו ל ע
זגולעס	ז ג ו ל ע ס
זודיקן	ז ו ד י ק נ
זוכט	ז ו כ ט
זוכן	ז ו כ נ
זוכסטו	ז ו כ ס ט ו
זולצערס	ז ו ל צ ע ר ס
זום־זום־זום	ז ו מ ז ו מ ז ו מ
זומער	ז ו מ ע ר
זומער־לעבן	ז ו מ ע ר ל ע ב נ
זומערדיקע	ז ו מ ע ר ד י ק ע
זומערטאָג	ז ו מ ע ר ט אָ ג
זומערצײַט	ז ו מ ע ר צ ײַ ט
זומפּ	ז ו מ פּ
זומפּן	ז ו מ פּ נ
זון	ז ו נ
זונס	ז ו נ ס
זוסמאַנס	ז ו ס מ אַ נ ס
זופּט	ז ו פּ ט
זי	ז י
זיבן	ז י ב נ
זיבן־קאַנטיק	ז י ב נ ק אַ נ ט י ק
זיבעצן	ז י ב ע צ נ
זיד	ז י ד
זידלט	ז י ד ל ט
זידלען	ז י ד ל ע נ
זיך	ז י כ
זיכער	ז י כ ע ר
זיכערן	ז י כ ע ר נ
זיכערע	ז י כ ע ר ע
זיכערער	ז י כ ע ר ע ר
זיכרױנע	ז י כ ר ױ נ ע
זילבערנע	ז י ל ב ע ר נ ע
זילבערנעם	ז י ל ב ע ר נ ע מ
זילבערנער	ז י ל ב ע ר נ ע ר
זין	ז י נ
זינג	ז י נ ג
זינגט	ז י נ ג ט
זינגען	ז י נ ג ע נ
זינגענדיק	ז י נ ג ע נ ד י ק
זינגערלעך	ז י נ ג ע ר ל ע כ
זינד	ז י נ ד
זינט	ז י נ ט
זינען	ז י נ ע נ
זינקט	ז י נ ק ט
זיס	ז י ס
זיסן	ז י ס נ
זיסע	ז י ס ע
זיסער	ז י ס ע ר
זיסקײט	ז י ס ק ײ ט
זיץ	ז י צ
זיצט	ז י צ ט
זיצן	ז י צ נ
זיצנדיק	ז י צ נ ד י ק
זיקאָרן	ז י ק אָ ר נ
זיװעג	ז י װ ע ג
זיפֿצט	ז י פֿ צ ט
זיפֿצסט	ז י פֿ צ ס ט
זכוס־אָװעס	ז כ ו ס אָ װ ע ס
זכיִע	ז כ יִ ע
זלאָדי	ז ל אָ ד י
זלאָדיעװקע	ז ל אָ ד י ע װ ק ע
זמאַן־כערוסײנו	ז מ אַ נ כ ע ר ו ס ײ נ ו
זמאַן־סימכעסײנע	ז מ אַ נ ס י מ כ ע ס ײ נ ע
זע	ז ע
זעט	ז ע ט
זעכציק	ז ע כ צ י ק
זעכצן	ז ע כ צ נ
זעלביקן	ז ע ל ב י ק נ
זעלבן	ז ע ל ב נ
זעלבסטפֿאַרשטענדלעך	ז ע ל ב ס ט פֿ אַ ר ש ט ע נ ד ל ע כ
זעלבע	ז ע ל ב ע
זעלבער	ז ע ל ב ע ר
זעלטן־זעלטן	ז ע ל ט נ ז ע ל ט נ
זעלטענע	ז ע ל ט ע נ ע
זעלנער	ז ע ל נ ע ר
זעלנערישן	ז ע ל נ ע ר י ש נ
זעלנערישע	ז ע ל נ ע ר י ש ע
זעמל	ז ע מ ל
זעמער	ז ע מ ע ר
זען	ז ע נ
זענען	ז ע נ ע נ
זעסט	ז ע ס ט
זעסטו	ז ע ס ט ו
זעען	ז ע ע נ
זעענדיק	ז ע ע נ ד י ק
זעץ	ז ע צ
זעצט	ז ע צ ט
זעצן	ז ע צ נ
זעק	ז ע ק
זעקל	ז ע ק ל
זעקלעך	ז ע ק ל ע כ
זעקס	ז ע ק ס
זעקס־און־זיבעציק	ז ע ק ס ו נ ז י ב ע צ י ק
זעקסטן	ז ע ק ס ט נ
זשומען	ז ש ו מ ע נ
זשילעט	ז ש י ל ע ט
זשימנע	ז ש י מ נ ע
זשמוט	ז ש מ ו ט
זשע	ז ש ע
זשעדנע	ז ש ע ד נ ע
זשאַבעס	ז ש אַ ב ע ס
זשאַבקעלעך	ז ש אַ ב ק ע ל ע כ
זשאַלעװען	ז ש אַ ל ע װ ע נ
זױגן	ז ױ ג נ
זױגנדיקע	ז ױ ג נ ד י ק ע
זױכע	ז ױ כ ע
זױלן	ז ױ ל נ
זױמען	ז ױ מ ע נ
זױער	ז ױ ע ר
זױערטײג	ז ױ ע ר ט ײ ג
זױערס	ז ױ ע ר ס
זױערע	ז ױ ע ר ע
זױערער	ז ױ ע ר ע ר
זױפֿנדיק	ז ױ פֿ נ ד י ק
זײ	ז ײ
זײגער	ז ײ ג ע ר
זײגער־מאַכער	ז ײ ג ע ר מ אַ כ ע ר
זײגערס	ז ײ ג ע ר ס
זײדן	ז ײ ד נ
זײדע	ז ײ ד ע
זײדעניו	ז ײ ד ע נ י ו
זײדעשי	ז ײ ד ע ש י
זײכער	ז ײ כ ע ר
זײער	ז ײ ע ר
זײער־זײער	ז ײ ע ר ז ײ ע ר
זײערט	ז ײ ע ר ט
זײעריקע	ז ײ ע ר י ק ע
זײערן	ז ײ ע ר נ
זײערס	ז ײ ע ר ס
זײערע	ז ײ ע ר ע
זײערער	ז ײ ע ר ע ר
זײף	ז ײ פֿ
זײַ	ז ײַ
זײַדל	ז ײַ ד ל
זײַדן	ז ײַ ד נ
זײַדענע	ז ײַ ד ע נ ע
זײַדענעם	ז ײַ ד ע נ ע מ
זײַדענער	ז ײַ ד ע נ ע ר
זײַט	ז ײַ ט
זײַט־מיר־מױכל	ז ײַ ט מ י ר מ ױ כ ל
זײַטיקע	ז ײַ ט י ק ע
זײַטן	ז ײַ ט נ
זײַטװעג	ז ײַ ט װ ע ג
זײַלן	ז ײַ ל נ
זײַן	ז ײַ נ
זײַניקע	ז ײַ נ י ק ע
זײַנס	ז ײַ נ ס
זײַנע	ז ײַ נ ע
זײַנען	ז ײַ נ ע נ
זײַנער	ז ײַ נ ע ר
זײַעט	ז ײַ ע ט
זאַך	ז אַ כ
זאַכן	ז אַ כ נ
זאַכענישן	ז אַ כ ע נ י ש נ
זאַלץ	ז אַ ל צ
זאַלצמעסטל	ז אַ ל צ מ ע ס ט ל
זאַמד	ז אַ מ ד
זאַמלביכער	ז אַ מ ל ב י כ ע ר
זאַניטעצע	ז אַ נ י ט ע צ ע
זאַץ	ז אַ צ
זאַק	ז אַ ק
זאַפּאַני־בראַטאַ	ז אַ פּ אַ נ י ב ר אַ ט אַ
זאַפֿרען	ז אַ פֿ ר ע נ
זאָג	ז אָ ג
זאָגט	ז אָ ג ט
זאָגן	ז אָ ג נ
זאָגנדיק	ז אָ ג נ ד י ק
זאָטלט	ז אָ ט ל ט
זאָכער	ז אָ כ ע ר
זאָל	ז אָ ל
זאָלט	ז אָ ל ט
זאָלן	ז אָ ל נ
זאָלסט	ז אָ ל ס ט
זאָלסטו	ז אָ ל ס ט ו
זאָקן	ז אָ ק נ
זאָקן־בענדל	ז אָ ק נ ב ע נ ד ל
זאָרגט	ז אָ ר ג ט
זאָרגן	ז אָ ר ג נ
זאָרעכן	ז אָ ר ע כ נ
ט'װיל	ט װ י ל
טו	ט ו
טוט	ט ו ט
טוכלע	ט ו כ ל ע
טוליעט	ט ו ל י ע ט
טוליען	ט ו ל י ע נ
טומל	ט ו מ ל
טומפּיקן	ט ו מ פּ י ק נ
טון	ט ו נ
טונען	ט ו נ ע נ
טונק	ט ו נ ק
טונקל	ט ו נ ק ל
טונקל־טרױעריקע	ט ו נ ק ל ט ר ױ ע ר י ק ע
טונקעלן	ט ו נ ק ע ל נ
טונקעלע	ט ו נ ק ע ל ע
טונקעלער	ט ו נ ק ע ל ע ר
טוסטו	ט ו ס ט ו
טוען	ט ו ע נ
טוץ	ט ו צ
טוקן	ט ו ק נ
טורמע	ט ו ר מ ע
טושבעכאָסאָ	ט ו ש ב ע כ אָ ס אָ
טיטון	ט י ט ו נ
טיטל	ט י ט ל
טיטשקע	ט י ט ש ק ע
טיכל	ט י כ ל
טיכלעך	ט י כ ל ע כ
טיכער־שטאָף	ט י כ ע ר ש ט אָ פֿ
טילים	ט י ל י מ
טילים־זאָגן	ט י ל י מ ז אָ ג נ
טינט	ט י נ ט
טינטן	ט י נ ט נ
טיף	ט י פֿ
טיקן	ט י ק נ
טיקאַ	ט י ק אַ
טיר	ט י ר
טירן	ט י ר נ
טיש	ט י ש
טישבױרעס	ט י ש ב ױ ר ע ס
טישטעך	ט י ש ט ע כ
טישטשע	ט י ש ט ש ע
טישל	ט י ש ל
טישע	ט י ש ע
טישאָ	ט י ש אָ
טיפּעש	ט י פּ ע ש
טיפֿן	ט י פֿ נ
טיפֿע	ט י פֿ ע
טיפֿעניש	ט י פֿ ע נ י ש
טיפֿער	ט י פֿ ע ר
טיפֿער־טיפֿער	ט י פֿ ע ר ט י פֿ ע ר
טכום־שאַבעס	ט כ ו מ ש אַ ב ע ס
טכילעס	ט כ י ל ע ס
טכיִעס־המײסים	ט כ יִ ע ס ה מ ײ ס י מ
טנײַ	ט נ ײַ
טנאָיִם	ט נ אָ יִ מ
טעג	ט ע ג
טעכטער	ט ע כ ט ע ר
טעכטערל	ט ע כ ט ע ר ל
טעל	ט ע ל
טעלער	ט ע ל ע ר
טעמפּל	ט ע מ פּ ל
טעמפּעלע	ט ע מ פּ ע ל ע
טענער	ט ע נ ע ר
טענצל	ט ע נ צ ל
טעצל	ט ע צ ל
טעקסט	ט ע ק ס ט
טערוצים	ט ע ר ו צ י מ
טערעץ	ט ע ר ע צ
טערקײַ	ט ע ר ק ײַ
טעװע	ט ע װ ע
טעאַטער	ט ע אַ ט ע ר
טעאַטער־דירעקטאָר	ט ע אַ ט ע ר ד י ר ע ק ט אָ ר
טעפּ	ט ע פּ
טעפּל	ט ע פּ ל
טעפּלעך	ט ע פּ ל ע כ
טרונק	ט ר ו נ ק
טרוקן	ט ר ו ק נ
טרוקענע	ט ר ו ק ע נ ע
טרוקענער	ט ר ו ק ע נ ע ר
טרופּע	ט ר ו פּ ע
טריט	ט ר י ט
טרינק	ט ר י נ ק
טרינקט	ט ר י נ ק ט
טרינקען	ט ר י נ ק ע נ
טריסק	ט ר י ס ק
טריסקער	ט ר י ס ק ע ר
טריפֿן	ט ר י פֿ נ
טרעט	ט ר ע ט
טרענען	ט ר ע נ ע נ
טרעף	ט ר ע פֿ
טרער	ט ר ע ר
טרערן	ט ר ע ר נ
טרעפּ	ט ר ע פּ
טרעפּלעך	ט ר ע פּ ל ע כ
טרעפֿט	ט ר ע פֿ ט
טרעפֿן	ט ר ע פֿ נ
טרעפֿנדיק	ט ר ע פֿ נ ד י ק
טרױערדיקן	ט ר ױ ע ר ד י ק נ
טרױערט	ט ר ױ ע ר ט
טרױעריק	ט ר ױ ע ר י ק
טרױעריק־ליבער	ט ר ױ ע ר י ק ל י ב ע ר
טרױעריקע	ט ר ױ ע ר י ק ע
טרױעריקער	ט ר ױ ע ר י ק ע ר
טרױערסט	ט ר ױ ע ר ס ט
טרײסט	ט ר ײ ס ט
טרײסטן	ט ר ײ ס ט נ
טרײסל	ט ר ײ ס ל
טרײסלט	ט ר ײ ס ל ט
טרײסלען	ט ר ײ ס ל ע נ
טרײפֿע	ט ר ײ פֿ ע
טרײַבט	ט ר ײַ ב ט
טראַטװע	ט ר אַ ט װ ע
טראַטװעס	ט ר אַ ט װ ע ס
טראַך	ט ר אַ כ
טראַכט	ט ר אַ כ ט
טראַכטן	ט ר אַ כ ט נ
טראַמװײַ	ט ר אַ מ װ ײַ
טראַמװײַס	ט ר אַ מ װ ײַ ס
טראַנספּאָרט	ט ר אַ נ ס פּ אָ ר ט
טראָג	ט ר אָ ג
טראָגט	ט ר אָ ג ט
טראָגן	ט ר אָ ג נ
טראָגנדיק	ט ר אָ ג נ ד י ק
טראָגסט	ט ר אָ ג ס ט
טראָגעדיק	ט ר אָ ג ע ד י ק
טראָט	ט ר אָ ט
טראָטואַרן	ט ר אָ ט ו אַ ר נ
טראָץ	ט ר אָ צ
טראָק	ט ר אָ ק
טראָפּן	ט ר אָ פּ נ
טראָפּנס	ט ר אָ פּ נ ס
טשיקאַװע	ט ש י ק אַ װ ע
טשעמאָדאַנטשיק	ט ש ע מ אָ ד אַ נ ט ש י ק
טשערנאָבילסקיס	ט ש ע ר נ אָ ב י ל ס ק י ס
טשערנאָהוז	ט ש ע ר נ אָ ה ו ז
טשערקינעס	ט ש ע ר ק י נ ע ס
טשעפּעט	ט ש ע פּ ע ט
טשעפּען	ט ש ע פּ ע נ
טשװאָק	ט ש װ אָ ק
טשױרטש	ט ש ױ ר ט ש
טשוּװע	ט ש וּ װ ע
טװאַן	ט װ אַ נ
טװוּע	ט װ וּ ע
טױב	ט ױ ב
טױבן	ט ױ ב נ
טױבער	ט ױ ב ע ר
טױג	ט ױ ג
טױזנט	ט ױ ז נ ט
טױט	ט ױ ט
טױטן	ט ױ ט נ
טױטן־שטיבל	ט ױ ט נ ש ט י ב ל
טױטע	ט ױ ט ע
טױנעפּל	ט ױ נ ע פּ ל
טױע	ט ױ ע
טױער	ט ױ ע ר
טױערן	ט ױ ע ר נ
טױרע	ט ױ ר ע
טױשט	ט ױ ש ט
טױשן	ט ױ ש נ
טױשעװ	ט ױ ש ע װ
טױװל	ט ױ װ ל
טױװע	ט ױ װ ע
טױװאָלקן	ט ױ װ אָ ל ק נ
טױפֿעס	ט ױ פֿ ע ס
טײ	ט ײ
טײג	ט ײ ג
טײגל	ט ײ ג ל
טײל	ט ײ ל
טײלט	ט ײ ל ט
טײלן	ט ײ ל נ
טײקעף	ט ײ ק ע פֿ
טײַבל	ט ײַ ב ל
טײַטלט	ט ײַ ט ל ט
טײַך	ט ײַ כ
טײַכל	ט ײַ כ ל
טײַכס	ט ײַ כ ס
טײַמים	ט ײַ מ י מ
טײַנעט	ט ײַ נ ע ט
טײַנען	ט ײַ נ ע נ
טײַנעס	ט ײַ נ ע ס
טײַער	ט ײַ ע ר
טײַערן	ט ײַ ע ר נ
טײַערסטע	ט ײַ ע ר ס ט ע
טײַערע	ט ײַ ע ר ע
טײַערער	ט ײַ ע ר ע ר
טײַװע	ט ײַ װ ע
טאַטן	ט אַ ט נ
טאַטנס	ט אַ ט נ ס
טאַטע	ט אַ ט ע
טאַטע־מאַמע	ט אַ ט ע מ אַ מ ע
טאַטעס	ט אַ ט ע ס
טאַטעשי	ט אַ ט ע ש י
טאַכטױנימלעך	ט אַ כ ט ױ נ י מ ל ע כ
טאַכלעס	ט אַ כ ל ע ס
טאַכנונים	ט אַ כ נ ו נ י מ
טאַכעס	ט אַ כ ע ס
טאַכריכים	ט אַ כ ר י כ י מ
טאַכשעט	ט אַ כ ש ע ט
טאַליע	ט אַ ל י ע
טאַלמעטױרע	ט אַ ל מ ע ט ױ ר ע
טאַלעס	ט אַ ל ע ס
טאַם	ט אַ מ
טאַמעז	ט אַ מ ע ז
טאַמעװאַטע	ט אַ מ ע װ אַ ט ע
טאַנעס	ט אַ נ ע ס
טאַנץ	ט אַ נ צ
טאַנצט	ט אַ נ צ ט
טאַנצן	ט אַ נ צ נ
טאַנײסים	ט אַ נ ײ ס י מ
טאַנאַך	ט אַ נ אַ כ
טאַקט	ט אַ ק ט
טאַקסע	ט אַ ק ס ע
טאַקע	ט אַ ק ע
טאַרומעס	ט אַ ר ו מ ע ס
טאַרעראַם	ט אַ ר ע ר אַ מ
טאַראַקאַנעס	ט אַ ר אַ ק אַ נ ע ס
טאַשמעס	ט אַ ש מ ע ס
טאַפּ	ט אַ פּ
טאַפּן	ט אַ פּ נ
טאַפּסט	ט אַ פּ ס ט
טאַפֿלע	ט אַ פֿ ל ע
טאָ	ט אָ
טאָג	ט אָ ג
טאָגט	ט אָ ג ט
טאָטער	ט אָ ט ע ר
טאָך	ט אָ כ
טאָך־קעדײדיבער	ט אָ כ ק ע ד ײ ד י ב ע ר
טאָכטער	ט אָ כ ט ע ר
טאָכטערס	ט אָ כ ט ע ר ס
טאָל	ט אָ ל
טאָלאָטשינאָװס	ט אָ ל אָ ט ש י נ אָ װ ס
טאָמע	ט אָ מ ע
טאָמעד	ט אָ מ ע ד
טאָמער	ט אָ מ ע ר
טאָן	ט אָ נ
טאָעס	ט אָ ע ס
טאָר	ט אָ ר
טאָרבעס	ט אָ ר ב ע ס
טאָרגעס	ט אָ ר ג ע ס
טאָרטן	ט אָ ר ט נ
טאָרסטו	ט אָ ר ס ט ו
טאָװל	ט אָ װ ל
טאָפּ	ט אָ פּ
טאָפּל	ט אָ פּ ל
טאָפּאָלן	ט אָ פּ אָ ל נ
טאָפּאָלן־בױמער	ט אָ פּ אָ ל נ ב ױ מ ע ר
טאָפּאָלן־צװײַגן	ט אָ פּ אָ ל נ צ װ ײַ ג נ
טוּװיע	ט וּ װ י ע
טוּװיען	ט וּ װ י ע נ
טפּרוסס	ט פּ ר ו ס ס
טפֿו	ט פֿ ו
טפֿילן	ט פֿ י ל נ
טפֿילן־בײַטעלע	ט פֿ י ל נ ב ײַ ט ע ל ע
טפֿילע	ט פֿ י ל ע
טפֿיסע	ט פֿ י ס ע
טפֿאָכים	ט פֿ אָ כ י מ
יו	י ו
יוגנט	י ו ג נ ט
יודל	י ו ד ל
יודלס	י ו ד ל ס
יודלען	י ו ד ל ע נ
יודנס	י ו ד נ ס
יודעלע	י ו ד ע ל ע
יודאָפֿאָב	י ו ד אָ פֿ אָ ב
יוכט	י ו כ ט
יונג	י ו נ ג
יונג־בלוטיק	י ו נ ג ב ל ו ט י ק
יונגיטשקער	י ו נ ג י ט ש ק ע ר
יונגע	י ו נ ג ע
יונגע־לײַט	י ו נ ג ע ל ײַ ט
יונגע־מאַנטשיקלעך	י ו נ ג ע מ אַ נ ט ש י ק ל ע כ
יונגעטשקע	י ו נ ג ע ט ש ק ע
יונגען	י ו נ ג ע נ
יונגער	י ו נ ג ע ר
יונגער־מאַן	י ו נ ג ע ר מ אַ נ
יונגאַטש	י ו נ ג אַ ט ש
יוראָפּ	י ו ר אָ פּ
יעדן	י ע ד נ
יעדנפֿאַלס	י ע ד נ פֿ אַ ל ס
יעדע	י ע ד ע
יעדעס	י ע ד ע ס
יעדער	י ע ד ע ר
יעדערן	י ע ד ע ר נ
יעדערער	י ע ד ע ר ע ר
יעדױע־װעגילױ	י ע ד ױ ע װ ע ג י ל ױ
יעכעסקל	י ע כ ע ס ק ל
יעכעסקלס	י ע כ ע ס ק ל ס
יעכעסקלען	י ע כ ע ס ק ל ע נ
יעכאַפּױר	י ע כ אַ פּ ױ ר
יעמײ	י ע מ ײ
יענטע	י ע נ ט ע
יענטען	י ע נ ט ע נ
יענע	י ע נ ע
יענעם	י ע נ ע מ
יענעמס	י ע נ ע מ ס
יענער	י ע נ ע ר
יענץ	י ע נ צ
יענקיס	י ע נ ק י ס
יעס	י ע ס
יעסורים	י ע ס ו ר י מ
יעסױמים	י ע ס ױ מ י מ
יעסױמימדיקע	י ע ס ױ מ י מ ד י ק ע
יעסױמע	י ע ס ױ מ ע
יעצט	י ע צ ט
יערושע	י ע ר ו ש ע
יעריכעס	י ע ר י כ ע ס
יעשיװע	י ע ש י װ ע
יעשיװע־באַכורים	י ע ש י װ ע ב אַ כ ו ר י מ
יעשאַיאָהו	י ע ש אַ י אָ ה ו
יױך	י ױ כ
יױם	י ױ מ
יױנע	י ױ נ ע
יױסעף	י ױ ס ע פֿ
יױעשדיקן	י ױ ע ש ד י ק נ
יױצע־מין־האַקלאַל	י ױ צ ע מ י נ ה אַ ק ל אַ ל
יױרע־דײע	י ױ ר ע ד ײ ע
יױשער	י ױ ש ע ר
יױװל	י ױ װ ל
ייִד	י יִ ד
ייִדיש	י יִ ד י ש
ייִדישלעך	י יִ ד י ש ל ע כ
ייִדישן	י יִ ד י ש נ
ייִדישע	י יִ ד י ש ע
ייִדישער	י יִ ד י ש ע ר
ייִדישקײט	י יִ ד י ש ק ײ ט
ייִדל	י יִ ד ל
ייִדלס	י יִ ד ל ס
ייִדן	י יִ ד נ
ייִדעלע	י יִ ד ע ל ע
ייִדעלעך	י יִ ד ע ל ע כ
ייִדענע	י יִ ד ע נ ע
ייִכעס	י יִ כ ע ס
ייִמאַכשמױניק	י יִ מ אַ כ ש מ ױ נ י ק
ייִנגל	י יִ נ ג ל
ייִנגלעך	י יִ נ ג ל ע כ
ייִנגסטע	י יִ נ ג ס ט ע
ייִנגסטער	י יִ נ ג ס ט ע ר
ייִנגעלע	י יִ נ ג ע ל ע
ייִנגעלעס	י יִ נ ג ע ל ע ס
ייִנגערע	י יִ נ ג ע ר ע
ייִסגאַדאַל	י יִ ס ג אַ ד אַ ל
ייִסראָעל	י יִ ס ר אָ ע ל
ייִצכאָק	י יִ צ כ אָ ק
ייִצכאָק־לײב	י יִ צ כ אָ ק ל ײ ב
ייִשעװ־האַדאַאַס	י יִ ש ע װ ה אַ ד אַ אַ ס
יײַכל	י ײַ כ ל
יײַלע	י ײַ ל ע
יאַ	י אַ
יאַד	י אַ ד
יאַדאַכעס	י אַ ד אַ כ ע ס
יאַכשי	י אַ כ ש י
יאַם	י אַ מ
יאַם־אױס	י אַ מ ױ ס
יאַם־אײַן	י אַ מ ײַ נ
יאַמים	י אַ מ י מ
יאַנאָשעץ	י אַ נ אָ ש ע צ
יאַריד	י אַ ר י ד
יאַרמלקע	י אַ ר מ ל ק ע
יאַרשענען	י אַ ר ש ע נ ע נ
יאַש	י אַ ש
יאָ	י אָ
יאָג	י אָ ג
יאָגט	י אָ ג ט
יאָגן	י אָ ג נ
יאָגנדיקע	י אָ ג נ ד י ק ע
יאָדײע־סױפֿער	י אָ ד ײ ע ס ױ פֿ ע ר
יאָכלט	י אָ כ ל ט
יאָלד	י אָ ל ד
יאָם	י אָ מ
יאָם־װאָלײַלע	י אָ מ װ אָ ל ײַ ל ע
יאָמים־טױװים	י אָ מ י מ ט ױ װ י מ
יאָמים־נױרים	י אָ מ י מ נ ױ ר י מ
יאָמים־נױרעמדיקער	י אָ מ י מ נ ױ ר ע מ ד י ק ע ר
יאָמערן	י אָ מ ע ר נ
יאָמקיפּער	י אָ מ ק י פּ ע ר
יאָמקיפּער־קאָטן	י אָ מ ק י פּ ע ר ק אָ ט נ
יאָנטעװ	י אָ נ ט ע װ
יאָנטעװדיק	י אָ נ ט ע װ ד י ק
יאָנטעװדיקן	י אָ נ ט ע װ ד י ק נ
יאָנטעװדיקע	י אָ נ ט ע װ ד י ק ע
יאָנטעװדיקער	י אָ נ ט ע װ ד י ק ע ר
יאָנטױװים	י אָ נ ט ױ װ י מ
יאָסיע	י אָ ס י ע
יאָסל	י אָ ס ל
יאָסעם	י אָ ס ע מ
יאָסעפֿל	י אָ ס ע פֿ ל
יאָר	י אָ ר
יאָר־רעכענונג	י אָ ר ר ע כ ע נ ו נ ג
יאָרן	י אָ ר נ
יאָרע־שאָמאַיִם	י אָ ר ע ש אָ מ אַ יִ מ
יאָװן	י אָ װ נ
כ'האָב	כ ה אָ ב
כ'לעבן	כ ל ע ב נ
כולין	כ ו ל י נ
כומעש	כ ו מ ע ש
כומאָשים	כ ו מ אָ ש י מ
כוץ	כ ו צ
כוץ־לעדערעך־האַטעװע	כ ו צ ל ע ד ע ר ע כ ה אַ ט ע װ ע
כורבם	כ ו ר ב מ
כורװע	כ ו ר װ ע
כורװעס	כ ו ר װ ע ס
כופּע	כ ו פּ ע
כידושים	כ י ד ו ש י מ
כידעש	כ י ד ע ש
כידעש־טרעפֿער	כ י ד ע ש ט ר ע פֿ ע ר
כיט	כ י ט
כילעף	כ י ל ע פֿ
כילעק	כ י ל ע ק
כליפּעדיק	כ ל י פּ ע ד י ק
כמאַרע	כ מ אַ ר ע
כניפֿעלעך	כ נ י פֿ ע ל ע כ
כסידים	כ ס י ד י מ
כסידיש־נעגידיש	כ ס י ד י ש נ ע ג י ד י ש
כסידישער	כ ס י ד י ש ע ר
כעזשבם	כ ע ז ש ב מ
כעזשבענען	כ ע ז ש ב ע נ ע נ
כעזשבױנעס	כ ע ז ש ב ױ נ ע ס
כעמער	כ ע מ ע ר
כעסבן	כ ע ס ב נ
כעסעד	כ ע ס ע ד
כעסרױנעס	כ ע ס ר ױ נ ע ס
כעסאָרן	כ ע ס אָ ר נ
כעװרע	כ ע װ ר ע
כעװרע־מענטשן	כ ע װ ר ע מ ע נ ט ש נ
כעװרע־קאַדיסע	כ ע װ ר ע ק אַ ד י ס ע
כעװרעמאַן	כ ע װ ר ע מ אַ נ
כרעמזלעך	כ ר ע מ ז ל ע כ
כרײן	כ ר ײ נ
כשאַד	כ ש אַ ד
כװאַליע	כ װ אַ ל י ע
כװאַליע־אױס	כ װ אַ ל י ע ױ ס
כװאַליע־אײַן	כ װ אַ ל י ע ײַ נ
כװאַליעס	כ װ אַ ל י ע ס
כױדעש	כ ױ ד ע ש
כױטװע	כ ױ ט װ ע
כױלע	כ ױ ל ע
כױלעסן	כ ױ ל ע ס נ
כױקער־װעדױרעש	כ ױ ק ע ר װ ע ד ױ ר ע ש
כױשעד	כ ױ ש ע ד
כױשעך	כ ױ ש ע כ
כױװ	כ ױ װ
כױװעס	כ ױ װ ע ס
כײדער	כ ײ ד ע ר
כײדער־ייִנגל	כ ײ ד ע ר י יִ נ ג ל
כײדער־ייִנגלעך	כ ײ ד ע ר י יִ נ ג ל ע כ
כײדער־ייִנגעלע	כ ײ ד ע ר י יִ נ ג ע ל ע
כײלעק	כ ײ ל ע ק
כײלעװ	כ ײ ל ע װ
כײן	כ ײ נ
כײנעװדיק	כ ײ נ ע װ ד י ק
כײשעק	כ ײ ש ע ק
כיִעס	כ יִ ע ס
כיִער	כ יִ ע ר
כײַ	כ ײַ
כײַ־װעקײַעם	כ ײַ װ ע ק ײַ ע מ
כײַע	כ ײַ ע
כײַעס	כ ײַ ע ס
כאַ־כאַ־כאַ	כ אַ כ אַ כ אַ
כאַ־כאַ־כאַ־כאַ	כ אַ כ אַ כ אַ כ אַ
כאַזן	כ אַ ז נ
כאַזנס	כ אַ ז נ ס
כאַזער	כ אַ ז ע ר
כאַזערט	כ אַ ז ע ר ט
כאַזערישן	כ אַ ז ע ר י ש נ
כאַזײרים	כ אַ ז ײ ר י מ
כאַזײרימלעך	כ אַ ז ײ ר י מ ל ע כ
כאַזאָנים	כ אַ ז אָ נ י מ
כאַזאָקע	כ אַ ז אָ ק ע
כאַזאָרעס־האַשאַץ	כ אַ ז אָ ר ע ס ה אַ ש אַ צ
כאַטװע	כ אַ ט װ ע
כאַיונע	כ אַ י ו נ ע
כאַכאָמים	כ אַ כ אָ מ י מ
כאַליאַסטרע	כ אַ ל י אַ ס ט ר ע
כאַלע	כ אַ ל ע
כאַלעמױד	כ אַ ל ע מ ױ ד
כאַלעמױדיקן	כ אַ ל ע מ ױ ד י ק נ
כאַלעשט	כ אַ ל ע ש ט
כאַלעשן	כ אַ ל ע ש נ
כאַלױמעס	כ אַ ל ױ מ ע ס
כאַלאַט	כ אַ ל אַ ט
כאַלאַטל	כ אַ ל אַ ט ל
כאַמולע	כ אַ מ ו ל ע
כאַניקע	כ אַ נ י ק ע
כאַניקע־לעמפּלעך	כ אַ נ י ק ע ל ע מ פּ ל ע כ
כאַניפֿע	כ אַ נ י פֿ ע
כאַנע	כ אַ נ ע
כאַנע־סאָרעלעס	כ אַ נ ע ס אָ ר ע ל ע ס
כאַנען	כ אַ נ ע נ
כאַס־װעשאָלעם	כ אַ ס װ ע ש אָ ל ע מ
כאַסיע	כ אַ ס י ע
כאַסמעט	כ אַ ס מ ע ט
כאַסענע	כ אַ ס ע נ ע
כאַסענעס	כ אַ ס ע נ ע ס
כאַסקל	כ אַ ס ק ל
כאַצקל	כ אַ צ ק ל
כאַצקעלע	כ אַ צ ק ע ל ע
כאַקירע־ספֿאָרים	כ אַ ק י ר ע ס פֿ אָ ר י מ
כאַקרען	כ אַ ק ר ע נ
כאַראַקטער־ראָליסט	כ אַ ר אַ ק ט ע ר ר אָ ל י ס ט
כאַראָטע	כ אַ ר אָ ט ע
כאַרפּע	כ אַ ר פּ ע
כאַרפּעס	כ אַ ר פּ ע ס
כאַװער	כ אַ װ ע ר
כאַװערט	כ אַ װ ע ר ט
כאַװערטאָרנס	כ אַ װ ע ר ט אָ ר נ ס
כאַװערן	כ אַ װ ע ר נ
כאַװײרים	כ אַ װ ײ ר י מ
כאַיִם	כ אַ יִ מ
כאַיִם־כאָנע	כ אַ יִ מ כ אָ נ ע
כאַיִמטע	כ אַ יִ מ ט ע
כאַיִמס	כ אַ יִ מ ס
כאַיִמען	כ אַ יִ מ ע נ
כאַפּ	כ אַ פּ
כאַפּט	כ אַ פּ ט
כאַפּן	כ אַ פּ נ
כאַפּנדיק	כ אַ פּ נ ד י ק
כאַפּעניש	כ אַ פּ ע נ י ש
כאָטש	כ אָ ט ש
כאָכמע	כ אָ כ מ ע
כאָכמעס־האַדאָקטאָריע	כ אָ כ מ ע ס ה אַ ד אָ ק ט אָ ר י ע
כאָכמעס־האַכעזשבם	כ אָ כ מ ע ס ה אַ כ ע ז ש ב מ
כאָכעם	כ אָ כ ע מ
כאָלילע	כ אָ ל י ל ע
כאָלעם	כ אָ ל ע מ
כאָלערע	כ אָ ל ע ר ע
כאָמעטקעס	כ אָ מ ע ט ק ע ס
כאָסיד	כ אָ ס י ד
כאָסן	כ אָ ס נ
כאָסנס	כ אָ ס נ ס
כאָסנקאַלע	כ אָ ס נ ק אַ ל ע
כאָסער	כ אָ ס ע ר
כאָסער־דײע	כ אָ ס ע ר ד ײ ע
כאָצע	כ אָ צ ע
כאָצע־עלעל	כ אָ צ ע ע ל ע ל
כאָצע־עלעלדיק	כ אָ צ ע ע ל ע ל ד י ק
כאָרעװ	כ אָ ר ע װ
כאָשעװן	כ אָ ש ע װ נ
כפֿײצים	כ פֿ ײ צ י מ
לולקעס	ל ו ל ק ע ס
לונג	ל ו נ ג
לונג־און־לעבערס	ל ו נ ג ו נ ל ע ב ע ר ס
לוסטיקער	ל ו ס ט י ק ע ר
לוריע	ל ו ר י ע
לופֿט	ל ו פֿ ט
ליב	ל י ב
ליבלינגען	ל י ב ל י נ ג ע נ
ליבלעך	ל י ב ל ע כ
ליבן	ל י ב נ
ליבסטע	ל י ב ס ט ע
ליבע	ל י ב ע
ליבעס	ל י ב ע ס
ליבעסלידער	ל י ב ע ס ל י ד ע ר
ליבער	ל י ב ע ר
ליבשאַפֿט	ל י ב ש אַ פֿ ט
ליג	ל י ג
ליגט	ל י ג ט
ליגן	ל י ג נ
ליגנדיק	ל י ג נ ד י ק
ליגנער	ל י ג נ ע ר
לידל	ל י ד ל
ליוביסטיק	ל י ו ב י ס ט י ק
ליוסטרינענע	ל י ו ס ט ר י נ ע נ ע
ליטע	ל י ט ע
ליטװאַק	ל י ט װ אַ ק
ליטװאַקעס	ל י ט װ אַ ק ע ס
ליכט	ל י כ ט
ליכטיק	ל י כ ט י ק
ליכטיקן	ל י כ ט י ק נ
ליכטיקע	ל י כ ט י ק ע
ליכטיקער	ל י כ ט י ק ע ר
ליכטיקײט	ל י כ ט י ק ײ ט
ליכטיקײטן	ל י כ ט י ק ײ ט נ
ליכטל	ל י כ ט ל
ליכטלעך	ל י כ ט ל ע כ
ליכטעפֿעקטן	ל י כ ט ע פֿ ע ק ט נ
ליכטפֿלאַמען	ל י כ ט פֿ ל אַ מ ע נ
לימענע	ל י מ ע נ ע
לימאָנאַד	ל י מ אָ נ אַ ד
לינקס	ל י נ ק ס
לינקער	ל י נ ק ע ר
ליסט	ל י ס ט
ליציטירט	ל י צ י ט י ר ט
ליקדושעס	ל י ק ד ו ש ע ס
ליקערן	ל י ק ע ר נ
ליאַדע	ל י אַ ד ע
ליאַרעם	ל י אַ ר ע מ
ליאַפּעס	ל י אַ פּ ע ס
ליפּ	ל י פּ
ליפּן	ל י פּ נ
ליפּנבײמער	ל י פּ נ ב ײ מ ע ר
ליפּעס	ל י פּ ע ס
לן	ל נ
לעב	ל ע ב
לעבט	ל ע ב ט
לעבן	ל ע ב נ
לעבסט	ל ע ב ס ט
לעבעדיק	ל ע ב ע ד י ק
לעבעדיקע	ל ע ב ע ד י ק ע
לעבעדיקער	ל ע ב ע ד י ק ע ר
לעבעדיקערהײט	ל ע ב ע ד י ק ע ר ה ײ ט
לעדוגמע	ל ע ד ו ג מ ע
לעדער	ל ע ד ע ר
לעדערנע	ל ע ד ע ר נ ע
לעדערנעם	ל ע ד ע ר נ ע מ
לעדאָר	ל ע ד אָ ר
לעהאַכאָסן	ל ע ה אַ כ אָ ס נ
לעהאַװדל	ל ע ה אַ װ ד ל
לעז	ל ע ז
לעיטער	ל ע י ט ע ר
לעכעם	ל ע כ ע מ
לעכער	ל ע כ ע ר
לעכערדיקן	ל ע כ ע ר ד י ק נ
לעכערט	ל ע כ ע ר ט
לעכערן	ל ע כ ע ר נ
לעכעראָסײנו	ל ע כ ע ר אָ ס ײ נ ו
לעכאַטכילע	ל ע כ אַ ט כ י ל ע
לעכאַכאָמים	ל ע כ אַ כ אָ מ י מ
לעכאָלאַדײעס	ל ע כ אָ ל אַ ד ײ ע ס
לעמבערג	ל ע מ ב ע ר ג
לעמײַ	ל ע מ ײַ
לעמאַ	ל ע מ אַ
לעמאַן־האַסעם	ל ע מ אַ נ ה אַ ס ע מ
לעמאַנאַשעם	ל ע מ אַ נ אַ ש ע מ
לעמאָשל	ל ע מ אָ ש ל
לענג	ל ע נ ג
לענגלעכע	ל ע נ ג ל ע כ ע
לענגערע	ל ע נ ג ע ר ע
לענדער	ל ע נ ד ע ר
לעסאָף	ל ע ס אָ פֿ
לעצטגעלט	ל ע צ ט ג ע ל ט
לעצטן	ל ע צ ט נ
לעצטע	ל ע צ ט ע
לעצטער	ל ע צ ט ע ר
לעצעװען	ל ע צ ע װ ע נ
לעק	ל ע ק
לעקט	ל ע ק ט
לעקיש	ל ע ק י ש
לעקן	ל ע ק נ
לעקעך	ל ע ק ע כ
לעקעכער	ל ע ק ע כ ע ר
לעקאַבעץ	ל ע ק אַ ב ע צ
לעקאָװעד	ל ע ק אָ װ ע ד
לערן	ל ע ר נ
לערנט	ל ע ר נ ט
לערנסטו	ל ע ר נ ס ט ו
לערנען	ל ע ר נ ע נ
לערער	ל ע ר ע ר
לעשעם	ל ע ש ע מ
לעװראָכע	ל ע װ ר אָ כ ע
לעװײַע	ל ע װ ײַ ע
לעװאָנע	ל ע װ אָ נ ע
לעײלאָ	ל ע ײ ל אָ
לעפֿל	ל ע פֿ ל
לעפֿצן	ל ע פֿ צ נ
לױ	ל ױ
לױב	ל ױ ב
לױבט	ל ױ ב ט
לױט	ל ױ ט
לױמעך	ל ױ מ ע כ
לױן	ל ױ נ
לױף	ל ױ פֿ
לױפֿט	ל ױ פֿ ט
לױפֿן	ל ױ פֿ נ
לױפֿסט	ל ױ פֿ ס ט
לױפֿעניש	ל ױ פֿ ע נ י ש
לױפֿערס	ל ױ פֿ ע ר ס
לײב	ל ײ ב
לײבל	ל ײ ב ל
לײבן	ל ײ ב נ
לײבקע	ל ײ ב ק ע
לײג	ל ײ ג
לײגט	ל ײ ג ט
לײגן	ל ײ ג נ
לײדיק	ל ײ ד י ק
לײדיקן	ל ײ ד י ק נ
לײדיקע	ל ײ ד י ק ע
לײדיקער	ל ײ ד י ק ע ר
לײזט	ל ײ ז ט
לײזן	ל ײ ז נ
לײזער	ל ײ ז ע ר
לײזער־יאָסל	ל ײ ז ע ר י אָ ס ל
לײזער־יאָסלען	ל ײ ז ע ר י אָ ס ל ע נ
לײטער	ל ײ ט ע ר
לײם	ל ײ מ
לײעלע	ל ײ ע ל ע
לײענדיק	ל ײ ע נ ד י ק
לײענט	ל ײ ע נ ט
לײענען	ל ײ ע נ ע נ
לײצים	ל ײ צ י מ
לײצעס	ל ײ צ ע ס
לײקע	ל ײ ק ע
לײַ	ל ײַ
לײַב	ל ײַ ב
לײַדן	ל ײַ ד נ
לײַט	ל ײַ ט
לײַטזעליקײט	ל ײַ ט ז ע ל י ק ײ ט
לײַטישן	ל ײַ ט י ש נ
לײַטלעך	ל ײַ ט ל ע כ
לײַכט	ל ײַ כ ט
לײַכטן	ל ײַ כ ט נ
לײַכטע	ל ײַ כ ט ע
לײַכטער	ל ײַ כ ט ע ר
לײַװנט	ל ײַ װ נ ט
לײַװנטענע	ל ײַ װ נ ט ע נ ע
לאַג־בעױמער	ל אַ ג ב ע ױ מ ע ר
לאַטעס	ל אַ ט ע ס
לאַטקע	ל אַ ט ק ע
לאַיעהודים	ל אַ י ע ה ו ד י מ
לאַכט	ל אַ כ ט
לאַכלוטן	ל אַ כ ל ו ט נ
לאַכן	ל אַ כ נ
לאַכסט	ל אַ כ ס ט
לאַכעדיקס	ל אַ כ ע ד י ק ס
לאַכעדיקע	ל אַ כ ע ד י ק ע
לאַכאָדים	ל אַ כ אָ ד י מ
לאַכאָדימניצעס	ל אַ כ אָ ד י מ נ י צ ע ס
לאַמדן	ל אַ מ ד נ
לאַמטערנדלעך	ל אַ מ ט ע ר נ ד ל ע כ
לאַמטערנעס	ל אַ מ ט ע ר נ ע ס
לאַמעדװאָװ	ל אַ מ ע ד װ אָ װ
לאַנג	ל אַ נ ג
לאַנג־געפֿרױרענער	ל אַ נ ג ג ע פֿ ר ױ ר ע נ ע ר
לאַנג־שנײע־שנירלעך	ל אַ נ ג ש נ ײ ע ש נ י ר ל ע כ
לאַנגן	ל אַ נ ג נ
לאַנגע	ל אַ נ ג ע
לאַנגער	ל אַ נ ג ע ר
לאַנגערע	ל אַ נ ג ע ר ע
לאַנד	ל אַ נ ד
לאַסט	ל אַ ס ט
לאַשטשעט	ל אַ ש ט ש ע ט
לאַפּן	ל אַ פּ נ
לאַפּעס	ל אַ פּ ע ס
לאָ	ל אָ
לאָבוסדיקע	ל אָ ב ו ס ד י ק ע
לאָדן	ל אָ ד נ
לאָז	ל אָ ז
לאָזט	ל אָ ז ט
לאָזן	ל אָ ז נ
לאָזסטו	ל אָ ז ס ט ו
לאָמיך	ל אָ מ י כ
לאָמיר	ל אָ מ י ר
לאָמען	ל אָ מ ע נ
לאָמפּ	ל אָ מ פּ
לאָמפּן	ל אָ מ פּ נ
לאָנקעס	ל אָ נ ק ע ס
לאָעט	ל אָ ע ט
לאָק	ל אָ ק
לאָקן	ל אָ ק נ
לאָקשן	ל אָ ק ש נ
לאָרד	ל אָ ר ד
לאָשן	ל אָ ש נ
לאָשן־קױדעש	ל אָ ש נ ק ױ ד ע ש
לאָשעקל	ל אָ ש ע ק ל
לאָשעקלעך	ל אָ ש ע ק ל ע כ
לאָפּעטע	ל אָ פּ ע ט ע
מ'האָט	מ ה אָ ט
מ'זעט	מ ז ע ט
מ'מוז	מ מ ו ז
מוז	מ ו ז
מוזט	מ ו ז ט
מוזן	מ ו ז נ
מוזסט	מ ו ז ס ט
מוט	מ ו ט
מוטער	מ ו ט ע ר
מוטערלעכער	מ ו ט ע ר ל ע כ ע ר
מוטערס	מ ו ט ע ר ס
מוטשע	מ ו ט ש ע
מוטשעט	מ ו ט ש ע ט
מומע	מ ו מ ע
מוסעף	מ ו ס ע פֿ
מוסער	מ ו ס ע ר
מוסער־ספֿאָרים	מ ו ס ע ר ס פֿ אָ ר י מ
מוסרט	מ ו ס ר ט
מוסאָפֿים	מ ו ס אָ פֿ י מ
מורמלט	מ ו ר מ ל ט
מורקען	מ ו ר ק ע נ
מושטשינע	מ ו ש ט ש י נ ע
מופֿט	מ ו פֿ ט
מי	מ י
מי־שעאַמער	מ י ש ע אַ מ ע ר
מידבאָריעס	מ י ד ב אָ ר י ע ס
מידע	מ י ד ע
מידײע	מ י ד ײ ע
מידאָר	מ י ד אָ ר
מיזיניק	מ י ז י נ י ק
מיזמער	מ י ז מ ע ר
מיזרעך	מ י ז ר ע כ
מיזרעך־װאַנט	מ י ז ר ע כ װ אַ נ ט
מיט	מ י ט
מיטברענגען	מ י ט ב ר ע נ ג ע נ
מיטגעבראַכט	מ י ט ג ע ב ר אַ כ ט
מיטגעהאַלטן	מ י ט ג ע ה אַ ל ט נ
מיטגענומען	מ י ט ג ע נ ו מ ע נ
מיטגעשלעפּט	מ י ט ג ע ש ל ע פּ ט
מיטגעשאָקלט	מ י ט ג ע ש אָ ק ל ט
מיטלסטן	מ י ט ל ס ט נ
מיטן	מ י ט נ
מיטנעמען	מ י ט נ ע מ ע נ
מיטקאָװסקין	מ י ט ק אָ װ ס ק י נ
מיטשלעפּנדיק	מ י ט ש ל ע פּ נ ד י ק
מיטאָג	מ י ט אָ ג
מיטפֿירן	מ י ט פֿ י ר נ
מיך	מ י כ
מיכל	מ י כ ל
מיכלען	מ י כ ל ע נ
מיל	מ י ל
מיליאָן	מ י ל י אָ נ
מיליאָנען	מ י ל י אָ נ ע נ
מילך	מ י ל כ
מילכיקס	מ י ל כ י ק ס
מילכיקע	מ י ל כ י ק ע
מילכאָמע	מ י ל כ אָ מ ע
מילנער	מ י ל נ ע ר
מין	מ י נ
מין־אַשאָמאַיִם	מ י נ אַ ש אָ מ אַ יִ מ
מינדל	מ י נ ד ל
מינוט	מ י נ ו ט
מינטערט	מ י נ ט ע ר ט
מיני	מ י נ י
מינים	מ י נ י מ
מיניסטער	מ י נ י ס ט ע ר
מיניען	מ י נ י ע נ
מינכע	מ י נ כ ע
מינכע־צײַט	מ י נ כ ע צ ײַ ט
מינע	מ י נ ע
מינעג	מ י נ ע ג
מינאַסטאַם	מ י נ אַ ס ט אַ מ
מיסט	מ י ס ט
מיסטער	מ י ס ט ע ר
מיסטאַמע	מ י ס ט אַ מ ע
מיסכער	מ י ס כ ע ר
מיסנאַגדישער	מ י ס נ אַ ג ד י ש ע ר
מיסע־מעשונע	מ י ס ע מ ע ש ו נ ע
מיצװע	מ י צ װ ע
מיצװעס	מ י צ װ ע ס
מיצאַד	מ י צ אַ ד
מיקױעך	מ י ק ױ ע כ
מיקױעכן	מ י ק ױ ע כ נ
מיר	מ י ר
מיש	מ י ש
מישט	מ י ש ט
מישטײנס	מ י ש ט ײ נ ס
מישטאַדל	מ י ש ט אַ ד ל
מישן	מ י ש נ
מישנײַעסן	מ י ש נ ײַ ע ס נ
מישעלאָנו	מ י ש ע ל אָ נ ו
מישײשעס	מ י ש ײ ש ע ס
מישפּעטן	מ י ש פּ ע ט נ
מישפּאָכע	מ י ש פּ אָ כ ע
מישפּאָכע־גריבעלעך	מ י ש פּ אָ כ ע ג ר י ב ע ל ע כ
מישפּאָכעדיק	מ י ש פּ אָ כ ע ד י ק
מיאַטש	מ י אַ ט ש
מיפּנײ־דאַרקע־שאָלעם	מ י פּ נ ײ ד אַ ר ק ע ש אָ ל ע מ
מלאָכימדיק	מ ל אָ כ י מ ד י ק
מע	מ ע
מעבל	מ ע ב ל
מעג	מ ע ג
מעגושעם	מ ע ג ו ש ע מ
מעגט	מ ע ג ט
מעגלעך	מ ע ג ל ע כ
מעגן	מ ע ג נ
מעגסט	מ ע ג ס ט
מעגײַער	מ ע ג ײַ ע ר
מעדרעש	מ ע ד ר ע ש
מעהומע	מ ע ה ו מ ע
מעזומען	מ ע ז ו מ ע נ
מעזומאָנים	מ ע ז ו מ אָ נ י מ
מעזעקטאָװ	מ ע ז ע ק ט אָ װ
מעזאַקע	מ ע ז אַ ק ע
מעטופּל	מ ע ט ו פּ ל
מעטאָדעס	מ ע ט אָ ד ע ס
מעיבי	מ ע י ב י
מעיוכעס	מ ע י ו כ ע ס
מעיוכאָסים	מ ע י ו כ אָ ס י מ
מעיאַשעװ	מ ע י אַ ש ע װ
מעכוטן	מ ע כ ו ט נ
מעכוטאָנעסטע	מ ע כ ו ט אָ נ ע ס ט ע
מעכטיקע	מ ע כ ט י ק ע
מעכילע	מ ע כ י ל ע
מעכײַע	מ ע כ ײַ ע
מעכײַע־מײסים	מ ע כ ײַ ע מ ײ ס י מ
מעכײַע־נעפֿאָשעס	מ ע כ ײַ ע נ ע פֿ אָ ש ע ס
מעכאַבעד	מ ע כ אַ ב ע ד
מעכאַבער	מ ע כ אַ ב ע ר
מעכוּיעװ	מ ע כ וּ י ע װ
מעל	מ ע ל
מעלגעשעפֿט	מ ע ל ג ע ש ע פֿ ט
מעליס	מ ע ל י ס
מעליצעס	מ ע ל י צ ע ס
מעלעך	מ ע ל ע כ
מעלאַמדים	מ ע ל אַ מ ד י מ
מעלאַמעד	מ ע ל אַ מ ע ד
מעלאַװע־מאַלקע	מ ע ל אַ װ ע מ אַ ל ק ע
מעלאָכע	מ ע ל אָ כ ע
מעמײלע־מעקױמױ	מ ע מ ײ ל ע מ ע ק ױ מ ױ
מעמאַלע־מעקױמע	מ ע מ אַ ל ע מ ע ק ױ מ ע
מעמאַלע־מאָקעם	מ ע מ אַ ל ע מ אָ ק ע מ
מען	מ ע נ
מענדל	מ ע נ ד ל
מענדל־ליב	מ ע נ ד ל ל י ב
מענדלען	מ ע נ ד ל ע נ
מענדעלע	מ ע נ ד ע ל ע
מענטש	מ ע נ ט ש
מענטשל	מ ע נ ט ש ל
מענטשלעך	מ ע נ ט ש ל ע כ
מענטשלעכן	מ ע נ ט ש ל ע כ נ
מענטשלעכער	מ ע נ ט ש ל ע כ ע ר
מענטשן	מ ע נ ט ש נ
מענטשן־קרױן	מ ע נ ט ש נ ק ר ױ נ
מענטשנס	מ ע נ ט ש נ ס
מענטשעלעך	מ ע נ ט ש ע ל ע כ
מעני	מ ע נ י
מענין	מ ע נ י נ
מענער	מ ע נ ע ר
מעניִע	מ ע נ יִ ע
מענאַגן	מ ע נ אַ ג נ
מענאַשע	מ ע נ אַ ש ע
מענאַשעכע	מ ע נ אַ ש ע כ ע
מענאַשעכען	מ ע נ אַ ש ע כ ע נ
מענאַשען	מ ע נ אַ ש ע נ
מעס	מ ע ס
מעסוגל	מ ע ס ו ג ל
מעסופּעק	מ ע ס ו פּ ע ק
מעסט	מ ע ס ט
מעסיקעסדיקע	מ ע ס י ק ע ס ד י ק ע
מעסירעלע	מ ע ס י ר ע ל ע
מעסירעס־האַנעפֿעש	מ ע ס י ר ע ס ה אַ נ ע פֿ ע ש
מעסירעס־נעפֿעש	מ ע ס י ר ע ס נ ע פֿ ע ש
מעסעכטע	מ ע ס ע כ ט ע
מעסער	מ ע ס ע ר
מעסערל	מ ע ס ע ר ל
מעסאַבעװ	מ ע ס אַ ב ע װ
מעסאַקן	מ ע ס אַ ק נ
מעציִע	מ ע צ יִ ע
מעציִעס	מ ע צ יִ ע ס
מעקט	מ ע ק ט
מעקלער	מ ע ק ל ע ר
מעקלערס	מ ע ק ל ע ר ס
מעקן	מ ע ק נ
מעקסיקע	מ ע ק ס י ק ע
מעקײַעם	מ ע ק ײַ ע מ
מעקאַבל	מ ע ק אַ ב ל
מעקאַבל־פּאָנעם	מ ע ק אַ ב ל פּ אָ נ ע מ
מעקאַנע	מ ע ק אַ נ ע
מער	מ ע ר
מערכעץ	מ ע ר כ ע צ
מערסטנטײל	מ ע ר ס ט נ ט ײ ל
מערסטנטײלס	מ ע ר ס ט נ ט ײ ל ס
מערסטנס	מ ע ר ס ט נ ס
מערסטע	מ ע ר ס ט ע
מערער	מ ע ר ע ר
מערקט	מ ע ר ק ט
מעשוגע	מ ע ש ו ג ע
מעשוגענער	מ ע ש ו ג ע נ ע ר
מעשוגענערהײט	מ ע ש ו ג ע נ ע ר ה ײ ט
מעשולעך	מ ע ש ו ל ע כ
מעשומעד	מ ע ש ו מ ע ד
מעשונע	מ ע ש ו נ ע
מעשענע	מ ע ש ע נ ע
מעשענעם	מ ע ש ע נ ע מ
מעשיִעכן	מ ע ש יִ ע כ נ
מעשיִעכס	מ ע ש יִ ע כ ס
מעשאָלים	מ ע ש אָ ל י מ
מעשאָרערים	מ ע ש אָ ר ע ר י מ
מעװינים	מ ע װ י נ י מ
מעפֿאָרשים	מ ע פֿ אָ ר ש י מ
מױדע	מ ױ ד ע
מױכל	מ ױ כ ל
מױכער־ספֿאָרים	מ ױ כ ע ר ס פֿ אָ ר י מ
מױכער־ספֿאָרימניק	מ ױ כ ע ר ס פֿ אָ ר י מ נ י ק
מױל	מ ױ ל
מױעך	מ ױ ע כ
מױעל	מ ױ ע ל
מױעלשאַפֿט	מ ױ ע ל ש אַ פֿ ט
מױערל	מ ױ ע ר ל
מױערן	מ ױ ע ר נ
מױרע	מ ױ ר ע
מױרעדיק	מ ױ ר ע ד י ק
מױרעדיקע	מ ױ ר ע ד י ק ע
מױרעדיקער	מ ױ ר ע ד י ק ע ר
מױשע	מ ױ ש ע
מױשעלע	מ ױ ש ע ל ע
מײדל	מ ײ ד ל
מײדל־ציטערנדיק	מ ײ ד ל צ י ט ע ר נ ד י ק
מײדלס	מ ײ ד ל ס
מײדלעך	מ ײ ד ל ע כ
מײדלשי	מ ײ ד ל ש י
מײכע־טײסע	מ ײ כ ע ט ײ ס ע
מײלע	מ ײ ל ע
מײלעך	מ ײ ל ע כ
מײלעץ־יױשער	מ ײ ל ע צ י ױ ש ע ר
מײן	מ ײ נ
מײנט	מ ײ נ ט
מײנסטו	מ ײ נ ס ט ו
מײנסטנס	מ ײ נ ס ט נ ס
מײנען	מ ײ נ ע נ
מײסים	מ ײ ס י מ
מײער	מ ײ ע ר
מײװן	מ ײ װ נ
מיִעס	מ יִ ע ס
מיִעסן	מ יִ ע ס נ
מיִעסע	מ יִ ע ס ע
מיִעסער	מ יִ ע ס ע ר
מיִעסקײטן	מ יִ ע ס ק ײ ט נ
מײַ	מ ײַ
מײַ־	מ ײַ
מײַדט	מ ײַ ד ט
מײַז	מ ײַ ז
מײַכל	מ ײַ כ ל
מײַל	מ ײַ ל
מײַלכל	מ ײַ ל כ ל
מײַלע	מ ײַ ל ע
מײַלעכל	מ ײַ ל ע כ ל
מײַלעכלעך	מ ײַ ל ע כ ל ע כ
מײַלעס	מ ײַ ל ע ס
מײַלער	מ ײַ ל ע ר
מײַמאָרים	מ ײַ מ אָ ר י מ
מײַן	מ ײַ נ
מײַנס	מ ײַ נ ס
מײַנע	מ ײַ נ ע
מײַנעם	מ ײַ נ ע מ
מײַנעס	מ ײַ נ ע ס
מײַנער	מ ײַ נ ע ר
מײַסע	מ ײַ ס ע
מײַסעס	מ ײַ ס ע ס
מײַרעװ	מ ײַ ר ע װ
מאַ	מ אַ
מאַזל	מ אַ ז ל
מאַזלטאָװ	מ אַ ז ל ט אָ װ
מאַזעק	מ אַ ז ע ק
מאַטבײע	מ אַ ט ב ײ ע
מאַטמען	מ אַ ט מ ע נ
מאַטע	מ אַ ט ע
מאַטער	מ אַ ט ע ר
מאַטעריע	מ אַ ט ע ר י ע
מאַטערניש	מ אַ ט ע ר נ י ש
מאַטריִעך	מ אַ ט ר יִ ע כ
מאַטאָנע	מ אַ ט אָ נ ע
מאַטאָנעס	מ אַ ט אָ נ ע ס
מאַך	מ אַ כ
מאַכט	מ אַ כ ט
מאַכלױקע	מ אַ כ ל ױ ק ע
מאַכלױקעס	מ אַ כ ל ױ ק ע ס
מאַכמעס	מ אַ כ מ ע ס
מאַכן	מ אַ כ נ
מאַכנדיק	מ אַ כ נ ד י ק
מאַכנע	מ אַ כ נ ע
מאַכנעס	מ אַ כ נ ע ס
מאַכעטענעסטע	מ אַ כ ע ט ע נ ע ס ט ע
מאַכעטאָנים	מ אַ כ ע ט אָ נ י מ
מאַכער	מ אַ כ ע ר
מאַכשײפֿטע	מ אַ כ ש ײ פֿ ט ע
מאַכשײפֿע	מ אַ כ ש ײ פֿ ע
מאַכשאָװע	מ אַ כ ש אָ װ ע
מאַל	מ אַ ל
מאַלבושים	מ אַ ל ב ו ש י מ
מאַלבושימלעך	מ אַ ל ב ו ש י מ ל ע כ
מאַלבעש	מ אַ ל ב ע ש
מאַלגײרען	מ אַ ל ג ײ ר ע נ
מאַלינעס	מ אַ ל י נ ע ס
מאַלכעס־ברױטלעך	מ אַ ל כ ע ס ב ר ױ ט ל ע כ
מאַלכאַמאָװעס	מ אַ ל כ אַ מ אָ װ ע ס
מאַלעך־מײלעץ	מ אַ ל ע כ מ ײ ל ע צ
מאַלעכס	מ אַ ל ע כ ס
מאַלערוסיש	מ אַ ל ע ר ו ס י ש
מאַלקע	מ אַ ל ק ע
מאַלקעלע	מ אַ ל ק ע ל ע
מאַלקעלען	מ אַ ל ק ע ל ע נ
מאַלקעלעס	מ אַ ל ק ע ל ע ס
מאַלאָכים	מ אַ ל אָ כ י מ
מאַלאָכימלעך	מ אַ ל אָ כ י מ ל ע כ
מאַלאָכימס	מ אַ ל אָ כ י מ ס
מאַמזערישע	מ אַ מ ז ע ר י ש ע
מאַמזײרים	מ אַ מ ז ײ ר י מ
מאַמע	מ אַ מ ע
מאַמעלאָשן	מ אַ מ ע ל אָ ש נ
מאַמען	מ אַ מ ע נ
מאַמעס	מ אַ מ ע ס
מאַמעש	מ אַ מ ע ש
מאַמאָשעס	מ אַ מ אָ ש ע ס
מאַן	מ אַ נ
מאַנטל	מ אַ נ ט ל
מאַנטלען	מ אַ נ ט ל ע נ
מאַנישקע	מ אַ נ י ש ק ע
מאַניפֿאָרגע	מ אַ נ י פֿ אָ ר ג ע
מאַנס	מ אַ נ ס
מאַנספּערזאָנען	מ אַ נ ס פּ ע ר ז אָ נ ע נ
מאַנספּאַרשױנען	מ אַ נ ס פּ אַ ר ש ױ נ ע נ
מאַנצביל	מ אַ נ צ ב י ל
מאַנצבילדיק	מ אַ נ צ ב י ל ד י ק
מאַנצבילן	מ אַ נ צ ב י ל נ
מאַנצבילש	מ אַ נ צ ב י ל ש
מאַנצבילשן	מ אַ נ צ ב י ל ש נ
מאַנצבילשע	מ אַ נ צ ב י ל ש ע
מאַנצבילשער	מ אַ נ צ ב י ל ש ע ר
מאַסן	מ אַ ס נ
מאַסע	מ אַ ס ע
מאַסערט	מ אַ ס ע ר ט
מאַסקעם	מ אַ ס ק ע מ
מאַסאַזש	מ אַ ס אַ ז ש
מאַצליִעך	מ אַ צ ל יִ ע כ
מאַצע	מ אַ צ ע
מאַצע־שמורע	מ אַ צ ע ש מ ו ר ע
מאַצעס	מ אַ צ ע ס
מאַצײװע	מ אַ צ ײ װ ע
מאַצײװעס	מ אַ צ ײ װ ע ס
מאַקע	מ אַ ק ע
מאַקעס	מ אַ ק ע ס
מאַרבין	מ אַ ר ב י נ
מאַרכבײן	מ אַ ר כ ב ײ נ
מאַרק	מ אַ ר ק
מאַרקעס	מ אַ ר ק ע ס
מאַרש	מ אַ ר ש
מאַרשאַס	מ אַ ר ש אַ ס
מאַשין	מ אַ ש י נ
מאַשינע	מ אַ ש י נ ע
מאַשינעס	מ אַ ש י נ ע ס
מאַשקע	מ אַ ש ק ע
מאַשקאָנעס	מ אַ ש ק אָ נ ע ס
מאַיִם	מ אַ יִ מ
מאַיִם־אַכרױנים־װאַסער	מ אַ יִ מ אַ כ ר ױ נ י מ װ אַ ס ע ר
מאַפּאָלע	מ אַ פּ אָ ל ע
מאַפֿטיִעך	מ אַ פֿ ט יִ ע כ
מאָגן	מ אָ ג נ
מאָגן־דאָװעד	מ אָ ג נ ד אָ װ ע ד
מאָגן־אָװעס	מ אָ ג נ אָ װ ע ס
מאָגערס	מ אָ ג ע ר ס
מאָדנע	מ אָ ד נ ע
מאָדנעם	מ אָ ד נ ע מ
מאָדנער	מ אָ ד נ ע ר
מאָדע	מ אָ ד ע
מאָדעס	מ אָ ד ע ס
מאָטיװ	מ אָ ט י װ
מאָטיװן	מ אָ ט י װ נ
מאָטל	מ אָ ט ל
מאָטלען	מ אָ ט ל ע נ
מאָטעלע	מ אָ ט ע ל ע
מאָטעלעס	מ אָ ט ע ל ע ס
מאָל	מ אָ ל
מאָלט	מ אָ ל ט
מאָלן	מ אָ ל נ
מאָלע־גאַזלען	מ אָ ל ע ג אַ ז ל ע נ
מאָלע־רעציכע	מ אָ ל ע ר ע צ י כ ע
מאָנען	מ אָ נ ע נ
מאָנענדיק	מ אָ נ ע נ ד י ק
מאָנעפֿשעך	מ אָ נ ע פֿ ש ע כ
מאָנאַט	מ אָ נ אַ ט
מאָנאַרכס	מ אָ נ אַ ר כ ס
מאָנאָלאָג	מ אָ נ אָ ל אָ ג
מאָס	מ אָ ס
מאָקעם	מ אָ ק ע מ
מאָקעם־מענוכע	מ אָ ק ע מ מ ע נ ו כ ע
מאָרגן	מ אָ ר ג נ
מאָרדע	מ אָ ר ד ע
מאָרדעלע	מ אָ ר ד ע ל ע
מאָרטכע	מ אָ ר ט כ ע
מאָרטכען	מ אָ ר ט כ ע נ
מאָרעלן	מ אָ ר ע ל נ
מאָרער	מ אָ ר ע ר
מפּפֿו	מ פּ פֿ ו
נו	נ ו
נו־נו	נ ו נ ו
נוסעך	נ ו ס ע כ
נוץ	נ ו צ
ניגונים	נ י ג ו נ י מ
ניגן	נ י ג נ
ניגנדל	נ י ג נ ד ל
נידעריק	נ י ד ע ר י ק
נידעריקס	נ י ד ע ר י ק ס
נידעריקע	נ י ד ע ר י ק ע
נידעריקער	נ י ד ע ר י ק ע ר
ניונקעלע	נ י ו נ ק ע ל ע
ניט	נ י ט
ניט־פֿאַרגינער	נ י ט פֿ אַ ר ג י נ ע ר
ניטבאַקעש	נ י ט ב אַ ק ע ש
ניטאָ	נ י ט אָ
ניכטער	נ י כ ט ע ר
ניכע	נ י כ ע
נילע	נ י ל ע
נימעס	נ י מ ע ס
נימאַנד	נ י מ אַ נ ד
ניסים	נ י ס י מ
ניץ	נ י צ
ניצאָכן	נ י צ אָ כ נ
נישט	נ י ש ט
נישטאָ	נ י ש ט אָ
נישמער	נ י ש מ ע ר
נישקאָשע	נ י ש ק אָ ש ע
נישקאָשעדיק	נ י ש ק אָ ש ע ד י ק
ניװל־װענישטױמעם	נ י װ ל װ ע נ י ש ט ױ מ ע מ
ניאַװ־	נ י אַ װ
ניאַװקעט	נ י אַ װ ק ע ט
ניאַװקען	נ י אַ װ ק ע נ
ניפֿטער	נ י פֿ ט ע ר
נעבן	נ ע ב נ
נעבעך	נ ע ב ע כ
נעגידיש־כסידישע	נ ע ג י ד י ש כ ס י ד י ש ע
נעגידישן	נ ע ג י ד י ש נ
נעגידישע	נ ע ג י ד י ש ע
נעגידישער	נ ע ג י ד י ש ע ר
נעגידישקײט	נ ע ג י ד י ש ק ײ ט
נעגינע	נ ע ג י נ ע
נעגל	נ ע ג ל
נעגעלעך	נ ע ג ע ל ע כ
נעגײע	נ ע ג ײ ע
נעדאָיעד	נ ע ד אָ י ע ד
נעדאָרים	נ ע ד אָ ר י מ
נעז	נ ע ז
נעזל	נ ע ז ל
נעכט	נ ע כ ט
נעכטיקע	נ ע כ ט י ק ע
נעכטיקער	נ ע כ ט י ק ע ר
נעכטן	נ ע כ ט נ
נעכײַ	נ ע כ ײַ
נעלם	נ ע ל מ
נעלסאָן	נ ע ל ס אָ נ
נעם	נ ע מ
נעמט	נ ע מ ט
נעמיראָװער	נ ע מ י ר אָ װ ע ר
נעמסט	נ ע מ ס ט
נעמען	נ ע מ ע נ
נעמאָנעס	נ ע מ אָ נ ע ס
נעס	נ ע ס
נעסט	נ ע ס ט
נעסיִע	נ ע ס יִ ע
נעענטער	נ ע ע נ ט ע ר
נעקאָמע	נ ע ק אָ מ ע
נערװן	נ ע ר װ נ
נעשאָמע	נ ע ש אָ מ ע
נעשאָמע־ליכטלעך	נ ע ש אָ מ ע ל י כ ט ל ע כ
נעשאָמעס	נ ע ש אָ מ ע ס
נעװײלע	נ ע װ ײ ל ע
נעפּל	נ ע פּ ל
נעפּלען	נ ע פּ ל ע נ
נעפּרעמענע	נ ע פּ ר ע מ ע נ ע
נעפֿעש	נ ע פֿ ע ש
נעפֿאַשעס	נ ע פֿ אַ ש ע ס
נױגט	נ ױ ג ט
נױט	נ ױ ט
נױטיק	נ ױ ט י ק
נױטיקע	נ ױ ט י ק ע
נױטן	נ ױ ט נ
נױסע־האַמיטע	נ ױ ס ע ה אַ מ י ט ע
נױעג	נ ױ ע ג
נױעך	נ ױ ע כ
נױקעם־װענױטער	נ ױ ק ע מ װ ע נ ױ ט ע ר
נײן	נ ײ נ
נײַ	נ ײַ
נײַ־געבױרענעם	נ ײַ ג ע ב ױ ר ע נ ע מ
נײַגעריקײט	נ ײַ ג ע ר י ק ײ ט
נײַן	נ ײַ נ
נײַנציק	נ ײַ נ צ י ק
נײַס	נ ײַ ס
נײַע	נ ײַ ע
נײַעם	נ ײַ ע מ
נײַעס	נ ײַ ע ס
נײַער	נ ײַ ע ר
נאַ	נ אַ
נאַדן	נ אַ ד נ
נאַט	נ אַ ט
נאַטור	נ אַ ט ו ר
נאַטור־געזאַנג	נ אַ ט ו ר ג ע ז אַ נ ג
נאַטירלעך	נ אַ ט י ר ל ע כ
נאַיס	נ אַ י ס
נאַכט	נ אַ כ ט
נאַכט־יאַם	נ אַ כ ט י אַ מ
נאַכט־לאַמטערנדלעך	נ אַ כ ט ל אַ מ ט ע ר נ ד ל ע כ
נאַכט־שלײער	נ אַ כ ט ש ל ײ ע ר
נאַכטטױ	נ אַ כ ט ט ױ
נאַכטכאָר	נ אַ כ ט כ אָ ר
נאַכטנעפּל	נ אַ כ ט נ ע פּ ל
נאַכמען	נ אַ כ מ ע נ
נאַכעס	נ אַ כ ע ס
נאַס	נ אַ ס
נאַסלעכן	נ אַ ס ל ע כ נ
נאַסן	נ אַ ס נ
נאַסע	נ אַ ס ע
נאַסער	נ אַ ס ע ר
נאַציאָן	נ אַ צ י אָ נ
נאַקעט	נ אַ ק ע ט
נאַקעטע	נ אַ ק ע ט ע
נאַר	נ אַ ר
נאַריש	נ אַ ר י ש
נאַרישע	נ אַ ר י ש ע
נאַרישער	נ אַ ר י ש ע ר
נאַרישקײטן	נ אַ ר י ש ק ײ ט נ
נאַרן	נ אַ ר נ
נאַראָנים	נ אַ ר אָ נ י מ
נאַשער	נ אַ ש ע ר
נאַשערײַ	נ אַ ש ע ר ײַ
נאַװענאַד	נ אַ װ ע נ אַ ד
נאָגל	נ אָ ג ל
נאָגן	נ אָ ג נ
נאָגעד	נ אָ ג ע ד
נאָגעדס	נ אָ ג ע ד ס
נאָדל	נ אָ ד ל
נאָדלען	נ אָ ד ל ע נ
נאָז	נ אָ ז
נאָזפֿאַטשײלע	נ אָ ז פֿ אַ ט ש ײ ל ע
נאָטן	נ אָ ט נ
נאָטע	נ אָ ט ע
נאָטען	נ אָ ט ע נ
נאָטעס	נ אָ ט ע ס
נאָך	נ אָ כ
נאָך־ניט־באַװאַקסענע	נ אָ כ נ י ט ב אַ װ אַ ק ס ע נ ע
נאָך־פּײסעך	נ אָ כ פּ ײ ס ע כ
נאָך־פּײסעכדיקן	נ אָ כ פּ ײ ס ע כ ד י ק נ
נאָכגעבױגט	נ אָ כ ג ע ב ױ ג ט
נאָכגעבאָמבלט	נ אָ כ ג ע ב אָ מ ב ל ט
נאָכגעטראַכט	נ אָ כ ג ע ט ר אַ כ ט
נאָכגעטאָן	נ אָ כ ג ע ט אָ נ
נאָכגעיאָגט	נ אָ כ ג ע י אָ ג ט
נאָכגעלאָזט	נ אָ כ ג ע ל אָ ז ט
נאָכגעמאַכט	נ אָ כ ג ע מ אַ כ ט
נאָכגעצױגן	נ אָ כ ג ע צ ױ ג נ
נאָכגעשטופּט	נ אָ כ ג ע ש ט ו פּ ט
נאָכגעשלעפּט	נ אָ כ ג ע ש ל ע פּ ט
נאָכגעשאָלטן	נ אָ כ ג ע ש אָ ל ט נ
נאָכגעשאָקלט	נ אָ כ ג ע ש אָ ק ל ט
נאָכגעפֿאָרשט	נ אָ כ ג ע פֿ אָ ר ש ט
נאָכטאַנצן	נ אָ כ ט אַ נ צ נ
נאָכמאַכן	נ אָ כ מ אַ כ נ
נאָכן	נ אָ כ נ
נאָכן־אָנבײַסן	נ אָ כ נ אָ נ ב ײַ ס נ
נאָכציִען	נ אָ כ צ יִ ע נ
נאָמען	נ אָ מ ע נ
נאָענט	נ אָ ע נ ט
נאָענסטע	נ אָ ע נ ס ט ע
נאָר	נ אָ ר
נאָרקענדיק	נ אָ ר ק ע נ ד י ק
נאָװי	נ אָ װ י
ס'איז	ס י ז
ס'געשעט	ס ג ע ש ע ט
ס'דאָך	ס ד אָ כ
ס'האָבן	ס ה אָ ב נ
ס'האָט	ס ה אָ ט
ס'זאָל	ס ז אָ ל
ס'טוט	ס ט ו ט
ס'טײַטש	ס ט ײַ ט ש
ס'נײַ	ס נ ײַ
ס'קומט	ס ק ו מ ט
ס'קען	ס ק ע נ
ס'קאָל	ס ק אָ ל
ס'קאָן	ס ק אָ נ
ס'װעט	ס װ ע ט
ס'װערט	ס װ ע ר ט
ס'װײַזט	ס װ ײַ ז ט
ס'װאָלט	ס װ אָ ל ט
ס'אַ	ס אַ
סודע	ס ו ד ע
סוטערינע	ס ו ט ע ר י נ ע
סוקע	ס ו ק ע
סופֿליאָר	ס ו פֿ ל י אָ ר
סטודענטל	ס ט ו ד ע נ ט ל
סטוסאַקעס	ס ט ו ס אַ ק ע ס
סטעישאָנערי	ס ט ע י ש אָ נ ע ר י
סטעליע	ס ט ע ל י ע
סטענגעלע	ס ט ע נ ג ע ל ע
סטעפּאַן	ס ט ע פּ אַ נ
סטרונעס	ס ט ר ו נ ע ס
סטראַשען	ס ט ר אַ ש ע נ
סטראָנקעס	ס ט ר אָ נ ק ע ס
סטשערבעס	ס ט ש ע ר ב ע ס
סטײַטץ	ס ט ײַ ט צ
סטײַטש	ס ט ײַ ט ש
סטאַם	ס ט אַ מ
סטאַנציע	ס ט אַ נ צ י ע
סטאַר	ס ט אַ ר
סטאַפּט	ס ט אַ פּ ט
סטאָט	ס ט אָ ט
סטאָליער	ס ט אָ ל י ע ר
סטאָליאַרעס	ס ט אָ ל י אַ ר ע ס
סיבע	ס י ב ע
סידער	ס י ד ע ר
סידערל	ס י ד ע ר ל
סילעק	ס י ל ע ק
סימכע	ס י מ כ ע
סימכעס	ס י מ כ ע ס
סימכעס־טױרע	ס י מ כ ע ס ט ױ ר ע
סימען	ס י מ ע נ
סינע	ס י נ ע
סינאַגאָגע	ס י נ אַ ג אָ ג ע
סיצן	ס י צ נ
סכירעס	ס כ י ר ע ס
סכױרע	ס כ ױ ר ע
סכױרעס	ס כ ױ ר ע ס
סליכעס	ס ל י כ ע ס
סליכעס־צײַט	ס ל י כ ע ס צ ײַ ט
סליעדאָװאַטל	ס ל י ע ד אָ װ אַ ט ל
סלאַף	ס ל אַ פֿ
סמיכעס־האַפּאַרשע	ס מ י כ ע ס ה אַ פּ אַ ר ש ע
סמעטענע	ס מ ע ט ע נ ע
סמאַלינע	ס מ אַ ל י נ ע
סמאָלע	ס מ אָ ל ע
סנאַסט	ס נ אַ ס ט
סע	ס ע
סעדער	ס ע ד ע ר
סעדרע	ס ע ד ר ע
סעמען	ס ע מ ע נ
סענאַט	ס ע נ אַ ט
סענאַטאָרן	ס ע נ אַ ט אָ ר נ
סערמיענגע	ס ע ר מ י ע נ ג ע
סערמענגע	ס ע ר מ ע נ ג ע
סצענע	ס צ ע נ ע
סקיצן	ס ק י צ נ
סקריפּ	ס ק ר י פּ
סקריפּען	ס ק ר י פּ ע נ
סקאַטינע	ס ק אַ ט י נ ע
סקאַטינעס	ס ק אַ ט י נ ע ס
סקאַטינאַ	ס ק אַ ט י נ אַ
סקאַנדאַל	ס ק אַ נ ד אַ ל
סרײפֿע	ס ר ײ פֿ ע
סראָרעס	ס ר אָ ר ע ס
סװיװע	ס װ י װ ע
סװיװעס	ס װ י װ ע ס
סװאָרע	ס װ אָ ר ע
סױדעט	ס ױ ד ע ט
סױדען	ס ױ ד ע נ
סױדעס	ס ױ ד ע ס
סױדעסדיקע	ס ױ ד ע ס ד י ק ע
סױכער	ס ױ כ ע ר
סױנע	ס ױ נ ע
סױנע־ייִסראָעל	ס ױ נ ע י יִ ס ר אָ ע ל
סױנעטע	ס ױ נ ע ט ע
סײדער	ס ײ ד ע ר
סײכל	ס ײ כ ל
סײפֿער	ס ײ פֿ ע ר
סײַ	ס ײַ
סײַדן	ס ײַ ד נ
סאַך	ס אַ כ
סאַכאַקל	ס אַ כ אַ ק ל
סאַלאָן	ס אַ ל אָ נ
סאַם־אַמאָװעס	ס אַ מ אַ מ אָ װ ע ס
סאַמע	ס אַ מ ע
סאַמעט	ס אַ מ ע ט
סאַמעט־בלעטל	ס אַ מ ע ט ב ל ע ט ל
סאַמעטן	ס אַ מ ע ט נ
סאַמעטענע	ס אַ מ ע ט ע נ ע
סאַמעטענער	ס אַ מ ע ט ע נ ע ר
סאַמאָסים	ס אַ מ אָ ס י מ
סאַנדעקאָעס	ס אַ נ ד ע ק אָ ע ס
סאַקאָנע	ס אַ ק אָ נ ע
סאַקאָנעס	ס אַ ק אָ נ ע ס
סאַקאָנעס־נעפֿאָשעס	ס אַ ק אָ נ ע ס נ ע פֿ אָ ש ע ס
סאָד	ס אָ ד
סאָדע־װאַסער	ס אָ ד ע װ אַ ס ע ר
סאָטן	ס אָ ט נ
סאָכרים	ס אָ כ ר י מ
סאָכרימלעך	ס אָ כ ר י מ ל ע כ
סאָלאָװײטשיק	ס אָ ל אָ װ ײ ט ש י ק
סאָנים	ס אָ נ י מ
סאָנישניק	ס אָ נ י ש נ י ק
סאָנישניקעס	ס אָ נ י ש נ י ק ע ס
סאָף	ס אָ פֿ
סאָקאָלסקין	ס אָ ק אָ ל ס ק י נ
סאָרטן	ס אָ ר ט נ
סאָפּנדיקע	ס אָ פּ נ ד י ק ע
סאָפּראַנאָ	ס אָ פּ ר אַ נ אָ
סאָפּראַנאָ־שטימע	ס אָ פּ ר אַ נ אָ ש ט י מ ע
סאָפֿע	ס אָ פֿ ע
סאָפֿקל־סאָף	ס אָ פֿ ק ל ס אָ פֿ
ספּעציאַליסט	ס פּ ע צ י אַ ל י ס ט
ספּעציאַליסטן	ס פּ ע צ י אַ ל י ס ט נ
ספּעציאַלנאָסט	ס פּ ע צ י אַ ל נ אָ ס ט
ספּאַזמע	ס פּ אַ ז מ ע
ספּאָדיק	ס פּ אָ ד י ק
ספֿאָרים	ס פֿ אָ ר י מ
עט	ע ט
עטלעכע	ע ט ל ע כ ע
עטװאָס	ע ט װ אָ ס
עך	ע כ
עלטסטע	ע ל ט ס ט ע
עלטסטער	ע ל ט ס ט ע ר
עלטער	ע ל ט ע ר
עלטערן	ע ל ט ע ר נ
עלטערע	ע ל ט ע ר ע
עלטערער	ע ל ט ע ר ע ר
עליע	ע ל י ע
עליען	ע ל י ע נ
עליעס	ע ל י ע ס
עלנבױגן	ע ל נ ב ױ ג נ
עלנבױגנס	ע ל נ ב ױ ג נ ס
עלנט	ע ל נ ט
עלנטע	ע ל נ ט ע
עלעהײ	ע ל ע ה ײ
עלעס־האַשאָכער	ע ל ע ס ה אַ ש אָ כ ע ר
עלף	ע ל פֿ
עמעס	ע מ ע ס
עמעסן	ע מ ע ס נ
עמעסע	ע מ ע ס ע
עמעסער	ע מ ע ס ע ר
עמעץ	ע מ ע צ
עמעצן	ע מ ע צ נ
עמעצער	ע מ ע צ ע ר
עמער	ע מ ע ר
עמער־פֿלױמען	ע מ ע ר פֿ ל ױ מ ע נ
עמערלעך	ע מ ע ר ל ע כ
עמערס	ע מ ע ר ס
ענג	ע נ ג
ענגליש	ע נ ג ל י ש
ענגלישן	ע נ ג ל י ש נ
ענגלישער	ע נ ג ל י ש ע ר
ענגלען	ע נ ג ל ע נ
ענגשאַפֿט	ע נ ג ש אַ פֿ ט
ענדיק	ע נ ד י ק
ענדיקט	ע נ ד י ק ט
ענדיקן	ע נ ד י ק נ
ענדלעך	ע נ ד ל ע כ
ענדערונג	ע נ ד ע ר ו נ ג
ענדערונגען	ע נ ד ע ר ו נ ג ע נ
ענטפֿער	ע נ ט פֿ ע ר
ענטפֿערט	ע נ ט פֿ ע ר ט
ענטפֿערן	ע נ ט פֿ ע ר נ
ענטפֿערנדיק	ע נ ט פֿ ע ר נ ד י ק
עס	ע ס
עסט	ע ס ט
עסיק	ע ס י ק
עסן	ע ס נ
עסנדיק	ע ס נ ד י ק
עסערס	ע ס ע ר ס
עסרױגים	ע ס ר ױ ג י מ
עסשטוב	ע ס ש ט ו ב
עע	ע ע
עע־הע־הע	ע ע ה ע ה ע
עעע	ע ע ע
עק	ע ק
עקדישן	ע ק ד י ש נ
עקזיסטירסט	ע ק ז י ס ט י ר ס ט
עקט	ע ק ט
עקן	ע ק נ
עקסטראַ	ע ק ס ט ר אַ
עקספּעדירט	ע ק ס פּ ע ד י ר ט
עקספּראָפּריאַציעס	ע ק ס פּ ר אָ פּ ר י אַ צ י ע ס
עקאָנאָמישע	ע ק אָ נ אָ מ י ש ע
ער	ע ר
ערגעץ	ע ר ג ע צ
ערגער	ע ר ג ע ר
ערגערן	ע ר ג ע ר נ
ערד	ע ר ד
ערדפֿלעקן	ע ר ד פֿ ל ע ק נ
ערטער	ע ר ט ע ר
ערלעכע	ע ר ל ע כ ע
ערלעכער	ע ר ל ע כ ע ר
ערלױבט	ע ר ל ױ ב ט
ערנסט	ע ר נ ס ט
ערנסטן	ע ר נ ס ט נ
ערנסטע	ע ר נ ס ט ע
ערנסטקײט	ע ר נ ס ט ק ײ ט
ערעץ־ייִסראָעל־עפּעלעך	ע ר ע צ י יִ ס ר אָ ע ל ע פּ ע ל ע כ
ערעװ	ע ר ע װ
ערעװ־שאַבעס	ע ר ע װ ש אַ ב ע ס
ערעװ־פּײסעך	ע ר ע װ פּ ײ ס ע כ
ערקװיקט	ע ר ק װ י ק ט
ערשט	ע ר ש ט
ערשטן	ע ר ש ט נ
ערשטנס	ע ר ש ט נ ס
ערשטע	ע ר ש ט ע
ערשטער	ע ר ש ט ע ר
ערװעקן	ע ר װ ע ק נ
ערפֿילט	ע ר פֿ י ל ט
ערפֿילן	ע ר פֿ י ל נ
ערפֿרישט	ע ר פֿ ר י ש ט
עװיגעס	ע װ י ג ע ס
עװן־עזרע	ע װ נ ע ז ר ע
עװנטאָװ	ע װ נ ט אָ װ
עפּל	ע פּ ל
עפּל־געשמאַק	ע פּ ל ג ע ש מ אַ ק
עפּלייִד	ע פּ ל י יִ ד
עפּעלע	ע פּ ע ל ע
עפּעס	ע פּ ע ס
עפּשטײן	ע פּ ש ט ײ נ
עפּשטײנען	ע פּ ש ט ײ נ ע נ
עפֿן	ע פֿ נ
עפֿנט	ע פֿ נ ט
עפֿענען	ע פֿ ע נ ע נ
עפֿשער	ע פֿ ש ע ר
צדאָקע־טעלער	צ ד אָ ק ע ט ע ל ע ר
צו	צ ו
צו־נאַכטס	צ ו נ אַ כ ט ס
צו־נאַכטס־רעכענונג	צ ו נ אַ כ ט ס ר ע כ ע נ ו נ ג
צואײַלן	צ ו ײַ ל נ
צוג	צ ו ג
צוגע־	צ ו ג ע
צוגעבונדן	צ ו ג ע ב ו נ ד נ
צוגעבן	צ ו ג ע ב נ
צוגעגעבן	צ ו ג ע ג ע ב נ
צוגעגעסן	צ ו ג ע ג ע ס נ
צוגעגרײט	צ ו ג ע ג ר ײ ט
צוגעגאַנגען	צ ו ג ע ג אַ נ ג ע נ
צוגעדעקט	צ ו ג ע ד ע ק ט
צוגעזען	צ ו ג ע ז ע נ
צוגעזעצט	צ ו ג ע ז ע צ ט
צוגעזאָגט	צ ו ג ע ז אָ ג ט
צוגעטראַכט	צ ו ג ע ט ר אַ כ ט
צוגעטראָגן	צ ו ג ע ט ר אָ ג נ
צוגעטשעפּעט	צ ו ג ע ט ש ע פּ ע ט
צוגעכאַפּט	צ ו ג ע כ אַ פּ ט
צוגעלעגערט	צ ו ג ע ל ע ג ע ר ט
צוגעלײגט	צ ו ג ע ל ײ ג ט
צוגעלאָזט	צ ו ג ע ל אָ ז ט
צוגעלאָזטע	צ ו ג ע ל אָ ז ט ע
צוגעמאַכט	צ ו ג ע מ אַ כ ט
צוגענומען	צ ו ג ע נ ו מ ע נ
צוגעקומען	צ ו ג ע ק ו מ ע נ
צוגעקוקט	צ ו ג ע ק ו ק ט
צוגעקילט	צ ו ג ע ק י ל ט
צוגעקליבן	צ ו ג ע ק ל י ב נ
צוגעקאָמפּאַניעט	צ ו ג ע ק אָ מ פּ אַ נ י ע ט
צוגערוקט	צ ו ג ע ר ו ק ט
צוגעשטיקט	צ ו ג ע ש ט י ק ט
צוגעשטעלט	צ ו ג ע ש ט ע ל ט
צוגעשיקט	צ ו ג ע ש י ק ט
צוגעשמײכלט	צ ו ג ע ש מ ײ כ ל ט
צוגעשאָקלט	צ ו ג ע ש אָ ק ל ט
צוגעפֿירט	צ ו ג ע פֿ י ר ט
צוגעפֿאָרן	צ ו ג ע פֿ אָ ר נ
צוגײן	צ ו ג ײ נ
צוגאָב	צ ו ג אָ ב
צוהאַלטן	צ ו ה אַ ל ט נ
צוזעצן	צ ו ז ע צ נ
צוזאַמען	צ ו ז אַ מ ע נ
צוזאַמענגעגאָסן	צ ו ז אַ מ ע נ ג ע ג אָ ס נ
צוזאַמענגעדריקט	צ ו ז אַ מ ע נ ג ע ד ר י ק ט
צוזאַמענגעהאָפֿטן	צ ו ז אַ מ ע נ ג ע ה אָ פֿ ט נ
צוזאַמענגעמישט	צ ו ז אַ מ ע נ ג ע מ י ש ט
צוזאַמענגענומען	צ ו ז אַ מ ע נ ג ע נ ו מ ע נ
צוזאַמענגעקלאַפּט	צ ו ז אַ מ ע נ ג ע ק ל אַ פּ ט
צוזאַמענקומען	צ ו ז אַ מ ע נ ק ו מ ע נ
צוליב	צ ו ל י ב
צוליבן	צ ו ל י ב נ
צולײגן	צ ו ל ײ ג נ
צולאָג	צ ו ל אָ ג
צולאָזן	צ ו ל אָ ז נ
צום	צ ו מ
צון	צ ו נ
צונג	צ ו נ ג
צונגען	צ ו נ ג ע נ
צונעמען	צ ו נ ע מ ע נ
צונעמעניש	צ ו נ ע מ ע נ י ש
צונױף	צ ו נ ױ פֿ
צונױפֿגעבונדן	צ ו נ ױ פֿ ג ע ב ו נ ד נ
צונױפֿגעבראַכט	צ ו נ ױ פֿ ג ע ב ר אַ כ ט
צונױפֿגעגאָסן	צ ו נ ױ פֿ ג ע ג אָ ס נ
צונױפֿגעלײגט	צ ו נ ױ פֿ ג ע ל ײ ג ט
צונױפֿגעלאָפֿן	צ ו נ ױ פֿ ג ע ל אָ פֿ נ
צונױפֿגענומען	צ ו נ ױ פֿ ג ע נ ו מ ע נ
צונױפֿגעװאַקסן	צ ו נ ױ פֿ ג ע װ אַ ק ס נ
צונױפֿלױפֿן	צ ו נ ױ פֿ ל ױ פֿ נ
צוצוגײן	צ ו צ ו ג ײ נ
צוצאָלן	צ ו צ אָ ל נ
צוק	צ ו ק
צוקער	צ ו ק ע ר
צוקער־זיס	צ ו ק ע ר ז י ס
צוקערניע	צ ו ק ע ר נ י ע
צוקאָפּנס	צ ו ק אָ פּ נ ס
צוריק	צ ו ר י ק
צוריקגעגעבן	צ ו ר י ק ג ע ג ע ב נ
צוריקגעקומען	צ ו ר י ק ג ע ק ו מ ע נ
צוריקקומענדיק	צ ו ר י ק ק ו מ ע נ ד י ק
צושטימונג	צ ו ש ט י מ ו נ ג
צושטעלן	צ ו ש ט ע ל נ
צושיקן	צ ו ש י ק נ
צופּ	צ ו פּ
צופּט	צ ו פּ ט
צופּן	צ ו פּ נ
צופֿוסנס	צ ו פֿ ו ס נ ס
צופֿירן	צ ו פֿ י ר נ
צופֿרידן	צ ו פֿ ר י ד נ
צופֿרידנהײט	צ ו פֿ ר י ד נ ה ײ ט
צי	צ י
ציבעלעס	צ י ב ע ל ע ס
ציבעלקעלעך	צ י ב ע ל ק ע ל ע כ
ציג	צ י ג
ציגל	צ י ג ל
ציגײַנער	צ י ג ײַ נ ע ר
ציגײַנערס	צ י ג ײַ נ ע ר ס
ציגאַר	צ י ג אַ ר
ציגאַרן	צ י ג אַ ר נ
ציט	צ י ט
ציטערדיקע	צ י ט ע ר ד י ק ע
ציטערט	צ י ט ע ר ט
ציטערן	צ י ט ע ר נ
ציטערנדיקע	צ י ט ע ר נ ד י ק ע
ציטערניש	צ י ט ע ר נ י ש
ציכטיק	צ י כ ט י ק
צימוקים־װײַן	צ י מ ו ק י מ װ ײַ נ
צימעס	צ י מ ע ס
צין	צ י נ
צינגל	צ י נ ג ל
צינדט	צ י נ ד ט
צינדן	צ י נ ד נ
ציצע־קאַנפֿעסלעך	צ י צ ע ק אַ נ פֿ ע ס ל ע כ
ציצעס	צ י צ ע ס
ציקלען	צ י ק ל ע נ
צירונג	צ י ר ו נ ג
ציפּן	צ י פּ נ
ציפּעט	צ י פּ ע ט
ציפֿערן	צ י פֿ ע ר נ
צנועדיק	צ נ ו ע ד י ק
צעבלוטיקטע	צ ע ב ל ו ט י ק ט ע
צעברעך	צ ע ב ר ע כ
צעברעכן	צ ע ב ר ע כ נ
צעבראָכן	צ ע ב ר אָ כ נ
צעבראָכענע	צ ע ב ר אָ כ ע נ ע
צעגיסט	צ ע ג י ס ט
צעגיסן	צ ע ג י ס נ
צעגעסן	צ ע ג ע ס נ
צעגײט	צ ע ג ײ ט
צעגײן	צ ע ג ײ נ
צעגײען	צ ע ג ײ ע נ
צעגאַנגען	צ ע ג אַ נ ג ע נ
צעגאַנגענער	צ ע ג אַ נ ג ע נ ע ר
צעגאַרטלט	צ ע ג אַ ר ט ל ט
צעגאָסן	צ ע ג אָ ס נ
צעדעך־לעדערעך	צ ע ד ע כ ל ע ד ע ר ע כ
צעדרײט	צ ע ד ר ײ ט
צעהיצט	צ ע ה י צ ט
צעהאַקט	צ ע ה אַ ק ט
צעזעצט	צ ע ז ע צ ט
צעטומלט	צ ע ט ו מ ל ט
צעטל	צ ע ט ל
צעטריבן	צ ע ט ר י ב נ
צעטײלט	צ ע ט ײ ל ט
צעטײלן	צ ע ט ײ ל נ
צעלאַכט	צ ע ל אַ כ ט
צעלאַכן	צ ע ל אַ כ נ
צעלאָזט	צ ע ל אָ ז ט
צעלאָזטע	צ ע ל אָ ז ט ע
צעלאָזן	צ ע ל אָ ז נ
צעלאָכעס	צ ע ל אָ כ ע ס
צעמישט	צ ע מ י ש ט
צעמאָלט	צ ע מ אָ ל ט
צען	צ ע נ
צען־פֿופֿצן	צ ע נ פֿ ו פֿ צ נ
צענדליק	צ ע נ ד ל י ק
צענדליקער־צענדליקער	צ ע נ ד ל י ק ע ר צ ע נ ד ל י ק ע ר
צענע־װערענאָ	צ ע נ ע װ ע ר ע נ אָ
צעקלאַפּן	צ ע ק ל אַ פּ נ
צעקעמט	צ ע ק ע מ ט
צעקריגט	צ ע ק ר י ג ט
צעקאַליעטשעט	צ ע ק אַ ל י ע ט ש ע ט
צעקאָכט	צ ע ק אָ כ ט
צערונען	צ ע ר ו נ ע נ
צערטלעך	צ ע ר ט ל ע כ
צערינט	צ ע ר י נ ט
צעריסן	צ ע ר י ס נ
צעריסענע	צ ע ר י ס ע נ ע
צעריסענעם	צ ע ר י ס ע נ ע מ
צערײַס	צ ע ר ײַ ס
צערײַסט	צ ע ר ײַ ס ט
צערײַסן	צ ע ר ײַ ס נ
צעשלאָגן	צ ע ש ל אָ ג נ
צעשמעטערט	צ ע ש מ ע ט ע ר ט
צעשניטן	צ ע ש נ י ט נ
צעשריִען	צ ע ש ר יִ ע נ
צעשרײַט	צ ע ש ר ײַ ט
צעשײדן	צ ע ש ײ ד נ
צעשפּיליעט	צ ע ש פּ י ל י ע ט
צעשפּאָלטן	צ ע ש פּ אָ ל ט נ
צעשפּאָלטענעם	צ ע ש פּ אָ ל ט ע נ ע מ
צעװײן	צ ע װ ײ נ
צעװײנט	צ ע װ ײ נ ט
צעװאָרפֿענע	צ ע װ אָ ר פֿ ע נ ע
צעפּ	צ ע פּ
צעפּלאָשעטע	צ ע פּ ל אָ ש ע ט ע
צעפּעלעך	צ ע פּ ע ל ע כ
צעפֿליקטע	צ ע פֿ ל י ק ט ע
צעפֿאַלן	צ ע פֿ אַ ל נ
צװיטשער	צ װ י ט ש ע ר
צװישן	צ װ י ש נ
צװעל	צ װ ע ל
צװעלף	צ װ ע ל פֿ
צװעלף־דרײַצן	צ װ ע ל פֿ ד ר ײַ צ נ
צװײ	צ װ ײ
צװײ־און־אַכציק	צ װ ײ ו נ אַ כ צ י ק
צװײ־דרײַ	צ װ ײ ד ר ײַ
צװײ־װעלטיק־ייִדל	צ װ ײ װ ע ל ט י ק י יִ ד ל
צװײט	צ װ ײ ט
צװײטן	צ װ ײ ט נ
צװײטנס	צ װ ײ ט נ ס
צװײטע	צ װ ײ ט ע
צװײטער	צ װ ײ ט ע ר
צװײען	צ װ ײ ע נ
צװײער	צ װ ײ ע ר
צװײפֿלען	צ װ ײ פֿ ל ע נ
צװײַג	צ װ ײַ ג
צװײַגל	צ װ ײַ ג ל
צװײַגלעך	צ װ ײַ ג ל ע כ
צװײַגן	צ װ ײַ ג נ
צװײַגעלע	צ װ ײַ ג ע ל ע
צװאַנציק	צ װ אַ נ צ י ק
צײכן	צ ײ כ נ
צײלט	צ ײ ל ט
צײן	צ ײ נ
צײנדאָקטער	צ ײ נ ד אָ ק ט ע ר
ציִען	צ יִ ע נ
ציִעניסט	צ יִ ע נ י ס ט
צײַט	צ ײַ ט
צײַטונגען	צ ײַ ט ו נ ג ע נ
צײַטיקע	צ ײַ ט י ק ע
צײַטיקער	צ ײַ ט י ק ע ר
צײַטן	צ ײַ ט נ
צאַד	צ אַ ד
צאַדעק	צ אַ ד ע ק
צאַדײקים	צ אַ ד ײ ק י מ
צאַהאָ	צ אַ ה אָ
צאַצקע	צ אַ צ ק ע
צאַצקעלע	צ אַ צ ק ע ל ע
צאַצקעס	צ אַ צ ק ע ס
צאַר	צ אַ ר
צאַר־באַלעכאַיִם	צ אַ ר ב אַ ל ע כ אַ יִ מ
צאַפּט	צ אַ פּ ט
צאַפּלט	צ אַ פּ ל ט
צאַפּן	צ אַ פּ נ
צאָהאָלע־װעסימכע	צ אָ ה אָ ל ע װ ע ס י מ כ ע
צאָלן	צ אָ ל נ
צאָן	צ אָ נ
צאָרע	צ אָ ר ע
צאָרעס	צ אָ ר ע ס
צוּװאַרפֿן	צ וּ װ אַ ר פֿ נ
קדושע	ק ד ו ש ע
קדושעס	ק ד ו ש ע ס
קודלעװאַטער	ק ו ד ל ע װ אַ ט ע ר
קוך	ק ו כ
קום	ק ו מ
קומט	ק ו מ ט
קומסט	ק ו מ ס ט
קומען	ק ו מ ע נ
קונדעס	ק ו נ ד ע ס
קונדײסים	ק ו נ ד ײ ס י מ
קונסט	ק ו נ ס ט
קונסטטעמפּל	ק ו נ ס ט ט ע מ פּ ל
קונץ	ק ו נ צ
קונציק	ק ו נ צ י ק
קונציקע	ק ו נ צ י ק ע
קונצן	ק ו נ צ נ
קוסטעס	ק ו ס ט ע ס
קוק	ק ו ק
קוקורעקו	ק ו ק ו ר ע ק ו
קוקט	ק ו ק ט
קוקן	ק ו ק נ
קוקנדיק	ק ו ק נ ד י ק
קוריערצוג	ק ו ר י ע ר צ ו ג
קורץ	ק ו ר צ
קורצן	ק ו ר צ נ
קורצע	ק ו ר צ ע
קוש	ק ו ש
קושט	ק ו ש ט
קושן	ק ו ש נ
קושעטקע	ק ו ש ע ט ק ע
קופּיעץ	ק ו פּ י ע צ
קופּער	ק ו פּ ע ר
קופּער־װאַסער	ק ו פּ ע ר װ אַ ס ע ר
קופּערנע	ק ו פּ ע ר נ ע
קופּערנעם	ק ו פּ ע ר נ ע מ
קופּקע	ק ו פּ ק ע
קופּקעלעך	ק ו פּ ק ע ל ע כ
קופּאָנעס	ק ו פּ אָ נ ע ס
קטאָ	ק ט אָ
קי	ק י
קידעש	ק י ד ע ש
קידאַט	ק י ד אַ ט
קידאַלטאָ	ק י ד אַ ל ט אָ
קידאַשטען	ק י ד אַ ש ט ע נ
קידאַשטעס	ק י ד אַ ש ט ע ס
קידאַשטאָ	ק י ד אַ ש ט אָ
קיטל	ק י ט ל
קיטע	ק י ט ע
קיך	ק י כ
קימאַט	ק י מ אַ ט
קינד	ק י נ ד
קינדלט	ק י נ ד ל ט
קינדלען	ק י נ ד ל ע נ
קינדס	ק י נ ד ס
קינדער	ק י נ ד ע ר
קינדערלעך	ק י נ ד ע ר ל ע כ
קינדערס	ק י נ ד ע ר ס
קינדװײַז	ק י נ ד װ ײַ ז
קינסטלעריש	ק י נ ס ט ל ע ר י ש
קינסטלערישן	ק י נ ס ט ל ע ר י ש נ
קינע	ק י נ ע
קינעס	ק י נ ע ס
קיסליצעס	ק י ס ל י צ ע ס
קיסע־האַקאָװעד	ק י ס ע ה אַ ק אָ װ ע ד
קיצער־האַדאָװער	ק י צ ע ר ה אַ ד אָ װ ע ר
קיקאָ	ק י ק אָ
קירך	ק י ר כ
קישן	ק י ש נ
קישנס	ק י ש נ ס
קישעלע	ק י ש ע ל ע
קישעלעך	ק י ש ע ל ע כ
קישעף	ק י ש ע פֿ
קלוג	ק ל ו ג
קלוגן	ק ל ו ג נ
קלוגע	ק ל ו ג ע
קלומעק	ק ל ו מ ע ק
קלומקעס	ק ל ו מ ק ע ס
קלונג	ק ל ו נ ג
קלינג	ק ל י נ ג
קלינגט	ק ל י נ ג ט
קלינגען	ק ל י נ ג ע נ
קלינגענדיק	ק ל י נ ג ע נ ד י ק
קלינגענדיקע	ק ל י נ ג ע נ ד י ק ע
קליאַמקע	ק ל י אַ מ ק ע
קלע־באַיִס	ק ל ע ב אַ יִ ס
קלע־זאַיִן	ק ל ע ז אַ יִ נ
קלע־קױדעש־װײַבער	ק ל ע ק ױ ד ע ש װ ײַ ב ע ר
קלעזמער	ק ל ע ז מ ע ר
קלעטערט	ק ל ע ט ע ר ט
קלעטערן	ק ל ע ט ע ר נ
קלעם	ק ל ע מ
קלענסטן	ק ל ע נ ס ט נ
קלענערן	ק ל ע נ ע ר נ
קלענערע	ק ל ע נ ע ר ע
קלעצל	ק ל ע צ ל
קלעצלעך	ק ל ע צ ל ע כ
קלעצלען	ק ל ע צ ל ע נ
קלעצער	ק ל ע צ ע ר
קלער	ק ל ע ר
קלעשטש	ק ל ע ש ט ש
קלעפּ	ק ל ע פּ
קלעפּט	ק ל ע פּ ט
קלעפּן	ק ל ע פּ נ
קלעפּעדיק	ק ל ע פּ ע ד י ק
קלױבט	ק ל ױ ב ט
קלױז	ק ל ױ ז
קלױמערשט	ק ל ױ מ ע ר ש ט
קלױסטער	ק ל ױ ס ט ע ר
קלײד	ק ל ײ ד
קלײדל	ק ל ײ ד ל
קלײדלעך	ק ל ײ ד ל ע כ
קלײדער	ק ל ײ ד ע ר
קלײדער־אַלמער	ק ל ײ ד ע ר אַ ל מ ע ר
קלײדערשאַנק	ק ל ײ ד ע ר ש אַ נ ק
קלײט	ק ל ײ ט
קלײן	ק ל ײ נ
קלײנינקע	ק ל ײ נ י נ ק ע
קלײניקײט	ק ל ײ נ י ק ײ ט
קלײנס	ק ל ײ נ ס
קלײנע	ק ל ײ נ ע
קלײנעם	ק ל ײ נ ע מ
קלײנער	ק ל ײ נ ע ר
קלײנערהײט	ק ל ײ נ ע ר ה ײ ט
קלײנװאַרג	ק ל ײ נ װ אַ ר ג
קלײַב	ק ל ײַ ב
קלײַבט	ק ל ײַ ב ט
קלאַל	ק ל אַ ל
קלאַנג	ק ל אַ נ ג
קלאַסן	ק ל אַ ס נ
קלאַפּ	ק ל אַ פּ
קלאַפּט	ק ל אַ פּ ט
קלאַפּן	ק ל אַ פּ נ
קלאַפּסט	ק ל אַ פּ ס ט
קלאָג	ק ל אָ ג
קלאָגט	ק ל אָ ג ט
קלאָגן	ק ל אָ ג נ
קלאָגעדיקע	ק ל אָ ג ע ד י ק ע
קלאָלעס	ק ל אָ ל ע ס
קלאָץ	ק ל אָ צ
קלאָר	ק ל אָ ר
קלאָרע	ק ל אָ ר ע
קלאָרער	ק ל אָ ר ע ר
קלאָװים	ק ל אָ װ י מ
קנופֿיע	ק נ ו פֿ י ע
קני	ק נ י
קנעבעלעך	ק נ ע ב ע ל ע כ
קנעט	ק נ ע ט
קנעטנדיק	ק נ ע ט נ ד י ק
קנעסעט־ייִסראָעל	ק נ ע ס ע ט י יִ ס ר אָ ע ל
קנעפּ	ק נ ע פּ
קנעפּלט	ק נ ע פּ ל ט
קנעפּלעך	ק נ ע פּ ל ע כ
קנײדלעך	ק נ ײ ד ל ע כ
קנײטש	ק נ ײ ט ש
קנײטשט	ק נ ײ ט ש ט
קנײטשן	ק נ ײ ט ש נ
קנײַפּט	ק נ ײַ פּ ט
קנײַפּן	ק נ ײַ פּ נ
קנאַל	ק נ אַ ל
קנאַק	ק נ אַ ק
קנאַקט	ק נ אַ ק ט
קנאַקן	ק נ אַ ק נ
קנאַקניסל	ק נ אַ ק נ י ס ל
קנאַפּ	ק נ אַ פּ
קנאָבלבאָרשט	ק נ אָ ב ל ב אָ ר ש ט
קסאַװ	ק ס אַ װ
קעגן	ק ע ג נ
קעדײ	ק ע ד ײ
קעדײַ	ק ע ד ײַ
קעהילע־מענטש	ק ע ה י ל ע מ ע נ ט ש
קעז	ק ע ז
קעיאַד־האַמײלעך	ק ע י אַ ד ה אַ מ ײ ל ע כ
קעכין	ק ע כ י נ
קעלבל	ק ע ל ב ל
קעלט	ק ע ל ט
קעלכל	ק ע ל כ ל
קעלנערל	ק ע ל נ ע ר ל
קעלער	ק ע ל ע ר
קעלעװ	ק ע ל ע װ
קען	ק ע נ
קענט	ק ע נ ט
קענטלעכער	ק ע נ ט ל ע כ ע ר
קעניגן	ק ע נ י ג נ
קענסט	ק ע נ ס ט
קענסטו	ק ע נ ס ט ו
קענען	ק ע נ ע נ
קענער	ק ע נ ע ר
קענערס	ק ע נ ע ר ס
קעסט	ק ע ס ט
קעסט־יונגע־לײַטלעך	ק ע ס ט י ו נ ג ע ל ײַ ט ל ע כ
קעסלפּױק	ק ע ס ל פּ ױ ק
קעסײדער	ק ע ס ײ ד ע ר
קעצל	ק ע צ ל
קעצעלעך	ק ע צ ע ל ע כ
קער	ק ע ר
קערבל	ק ע ר ב ל
קערבלעך	ק ע ר ב ל ע כ
קערט	ק ע ר ט
קערל	ק ע ר ל
קערלעך	ק ע ר ל ע כ
קערן	ק ע ר נ
קערנדל	ק ע ר נ ד ל
קערנדלעך	ק ע ר נ ד ל ע כ
קערנער	ק ע ר נ ע ר
קערעלעך	ק ע ר ע ל ע כ
קעשענע	ק ע ש ע נ ע
קעשענעס	ק ע ש ע נ ע ס
קעשענעװער	ק ע ש ע נ ע װ ע ר
קעאַני־בעפֿעסעך	ק ע אַ נ י ב ע פֿ ע ס ע כ
קעפּ	ק ע פּ
קעפּל	ק ע פּ ל
קעפּמענטשן	ק ע פּ מ ע נ ט ש נ
קעפּן	ק ע פּ נ
קעפּעלעך	ק ע פּ ע ל ע כ
קרוג	ק ר ו ג
קרוטין	ק ר ו ט י נ
קרום	ק ר ו מ
קרומע	ק ר ו מ ע
קרומען	ק ר ו מ ע נ
קריג	ק ר י ג
קריגט	ק ר י ג ט
קריגן	ק ר י ג נ
קריגעלע	ק ר י ג ע ל ע
קריגעלעך	ק ר י ג ע ל ע כ
קריכט	ק ר י כ ט
קריכן	ק ר י כ נ
קרימט	ק ר י מ ט
קרימעטאַרטערום	ק ר י מ ע ט אַ ר ט ע ר ו מ
קרימען	ק ר י מ ע נ
קריסט	ק ר י ס ט
קריצט	ק ר י צ ט
קרישטאָל	ק ר י ש ט אָ ל
קרישמע	ק ר י ש מ ע
קרישעלע	ק ר י ש ע ל ע
קריװדע	ק ר י װ ד ע
קרעדיט	ק ר ע ד י ט
קרעכץ	ק ר ע כ צ
קרעכצט	ק ר ע כ צ ט
קרעכצן	ק ר ע כ צ נ
קרעכצנדיק	ק ר ע כ צ נ ד י ק
קרעל	ק ר ע ל
קרעמער	ק ר ע מ ע ר
קרענק	ק ר ע נ ק
קרענקט	ק ר ע נ ק ט
קרענקען	ק ר ע נ ק ע נ
קרעװ	ק ר ע װ
קרעפּאָסט	ק ר ע פּ אָ ס ט
קרױן	ק ר ױ נ
קרױװים	ק ר ױ װ י מ
קרײַד	ק ר ײַ ד
קרײַטער	ק ר ײַ ט ע ר
קראַגנדל	ק ר אַ ג נ ד ל
קראַכעס	ק ר אַ כ ע ס
קראַמפּ	ק ר אַ מ פּ
קראַנק	ק ר אַ נ ק
קראַנקן	ק ר אַ נ ק נ
קראַנקן־כײדער	ק ר אַ נ ק נ כ ײ ד ע ר
קראַנקן־אַלקער	ק ר אַ נ ק נ אַ ל ק ע ר
קראַנקע	ק ר אַ נ ק ע
קראַנקער	ק ר אַ נ ק ע ר
קראַץ	ק ר אַ צ
קראַצט	ק ר אַ צ ט
קראַצן	ק ר אַ צ נ
קראַפֿט	ק ר אַ פֿ ט
קראָמען	ק ר אָ מ ע נ
קראָען	ק ר אָ ע נ
קראָקע	ק ר אָ ק ע
קראָשענװיצער	ק ר אָ ש ע נ װ י צ ע ר
קװיטל	ק װ י ט ל
קװיטש	ק װ י ט ש
קװיטשעט	ק װ י ט ש ע ט
קװיק	ק װ י ק
קװיקט	ק װ י ק ט
קװעטשט	ק װ ע ט ש ט
קװעטשן	ק װ ע ט ש נ
קװעלט	ק װ ע ל ט
קװערטל	ק װ ע ר ט ל
קװערטעלע	ק װ ע ר ט ע ל ע
קװאַס	ק װ אַ ס
קװאַס־עפּעלעך	ק װ אַ ס ע פּ ע ל ע כ
קװאַסניק	ק װ אַ ס נ י ק
קװאַרס	ק װ אַ ר ס
קװאָרים	ק װ אָ ר י מ
קױדעם	ק ױ ד ע מ
קױדעמקאָל	ק ױ ד ע מ ק אָ ל
קױכעס	ק ױ כ ע ס
קױל	ק ױ ל
קױלן	ק ױ ל נ
קױלע־קױלעס	ק ױ ל ע ק ױ ל ע ס
קױלעטש	ק ױ ל ע ט ש
קױלעטשן	ק ױ ל ע ט ש נ
קױלען	ק ױ ל ע נ
קױלעס	ק ױ ל ע ס
קױלערט	ק ױ ל ע ר ט
קױם	ק ױ מ
קױמענס	ק ױ מ ע נ ס
קױנים	ק ױ נ י מ
קױנסקער	ק ױ נ ס ק ע ר
קױנסקעװאָליע	ק ױ נ ס ק ע װ אָ ל י ע
קױנסקעװאָליער	ק ױ נ ס ק ע װ אָ ל י ע ר
קױנע	ק ױ נ ע
קױנעטעס	ק ױ נ ע ט ע ס
קױס	ק ױ ס
קױסעס	ק ױ ס ע ס
קױע	ק ױ ע
קױעך	ק ױ ע כ
קױף	ק ױ פֿ
קױצע־שעליוד	ק ױ צ ע ש ע ל י ו ד
קױרים	ק ױ ר י מ
קױרײע־קעדאַג	ק ױ ר ײ ע ק ע ד אַ ג
קױשע־װעױרעף	ק ױ ש ע װ ע ױ ר ע פֿ
קױפֿט	ק ױ פֿ ט
קױפֿן	ק ױ פֿ נ
קײזערלעכן	ק ײ ז ע ר ל ע כ נ
קײט	ק ײ ט
קײטן	ק ײ ט נ
קײטעלעך	ק ײ ט ע ל ע כ
קײלים	ק ײ ל י מ
קײלע	ק ײ ל ע
קײן	ק ײ נ
קײן־אײן־האָרע	ק ײ נ ײ נ ה אָ ר ע
קײנע	ק ײ נ ע
קײנעם	ק ײ נ ע מ
קײנער	ק ײ נ ע ר
קײסער	ק ײ ס ע ר
קײװער	ק ײ װ ע ר
קיִעװ	ק יִ ע װ
קײַ	ק ײַ
קײַט	ק ײַ ט
קײַכט	ק ײַ כ ט
קײַלעכדיק	ק ײַ ל ע כ ד י ק
קײַלעכדיקע	ק ײַ ל ע כ ד י ק ע
קײַלעכיק	ק ײַ ל ע כ י ק
קײַלעכיקע	ק ײַ ל ע כ י ק ע
קײַמעלאָן	ק ײַ מ ע ל אָ נ
קײַסן	ק ײַ ס נ
קײַען	ק ײַ ע נ
קײַקלען	ק ײַ ק ל ע נ
קאַבינעט	ק אַ ב י נ ע ט
קאַבינעטל	ק אַ ב י נ ע ט ל
קאַבצן	ק אַ ב צ נ
קאַבצאַנסק	ק אַ ב צ אַ נ ס ק
קאַבצאָנים	ק אַ ב צ אָ נ י מ
קאַבצאָנישע	ק אַ ב צ אָ נ י ש ע
קאַברען	ק אַ ב ר ע נ
קאַברענס	ק אַ ב ר ע נ ס
קאַבאָלעס־פּאָנעם	ק אַ ב אָ ל ע ס פּ אָ נ ע מ
קאַדמען	ק אַ ד מ ע נ
קאַדמױנים	ק אַ ד מ ױ נ י מ
קאַדעש	ק אַ ד ע ש
קאַדריל	ק אַ ד ר י ל
קאַטעגאָר	ק אַ ט ע ג אָ ר
קאַטערינקע	ק אַ ט ע ר י נ ק ע
קאַטעװען	ק אַ ט ע װ ע נ
קאַטשען	ק אַ ט ש ע נ
קאַטשקעס	ק אַ ט ש ק ע ס
קאַטאָרי	ק אַ ט אָ ר י
קאַטאָװעס	ק אַ ט אָ װ ע ס
קאַך־האַװע	ק אַ כ ה אַ װ ע
קאַלוזשעס	ק אַ ל ו ז ש ע ס
קאַלט	ק אַ ל ט
קאַלטן	ק אַ ל ט נ
קאַלטער	ק אַ ל ט ע ר
קאַליקע	ק אַ ל י ק ע
קאַלע	ק אַ ל ע
קאַלע־כײן	ק אַ ל ע כ ײ נ
קאַלע־מײדל	ק אַ ל ע מ ײ ד ל
קאַלעס	ק אַ ל ע ס
קאַם־זײַדענע	ק אַ מ ז ײַ ד ע נ ע
קאַמע־װעקאַמע	ק אַ מ ע װ ע ק אַ מ ע
קאַמעניץ	ק אַ מ ע נ י צ
קאַמעניצער	ק אַ מ ע נ י צ ע ר
קאַמערטאָן	ק אַ מ ע ר ט אָ נ
קאַמעראַד	ק אַ מ ע ר אַ ד
קאַמײעס	ק אַ מ ײ ע ס
קאַנטן	ק אַ נ ט נ
קאַנטשיק	ק אַ נ ט ש י ק
קאַנטאָר	ק אַ נ ט אָ ר
קאַניאָק	ק אַ נ י אָ ק
קאַנאַפּע	ק אַ נ אַ פּ ע
קאַנאַפּקע	ק אַ נ אַ פּ ק ע
קאַסרילעװקע	ק אַ ס ר י ל ע װ ק ע
קאַסרילעװקער	ק אַ ס ר י ל ע װ ק ע ר
קאַסװע־ראַבע	ק אַ ס װ ע ר אַ ב ע
קאַף־האַקעלע	ק אַ פֿ ה אַ ק ע ל ע
קאַץ	ק אַ צ
קאַצעװ	ק אַ צ ע װ
קאַצאָװים	ק אַ צ אָ װ י מ
קאַצאָװישער	ק אַ צ אָ װ י ש ע ר
קאַרב	ק אַ ר ב
קאַרבן	ק אַ ר ב נ
קאַרג	ק אַ ר ג
קאַרגן	ק אַ ר ג נ
קאַרטוזל	ק אַ ר ט ו ז ל
קאַרטאָפֿל	ק אַ ר ט אָ פֿ ל
קאַרטאָפֿליעס	ק אַ ר ט אָ פֿ ל י ע ס
קאַרעטן	ק אַ ר ע ט נ
קאַרשן	ק אַ ר ש נ
קאַשע	ק אַ ש ע
קאַשעס	ק אַ ש ע ס
קאַשקעטל	ק אַ ש ק ע ט ל
קאַװע	ק אַ װ ע
קאַװענע	ק אַ װ ע נ ע
קאַװענעס	ק אַ װ ע נ ע ס
קאַװעשאַנער	ק אַ װ ע ש אַ נ ע ר
קאַװאָנע	ק אַ װ אָ נ ע
קאַאַס	ק אַ אַ ס
קאַפּ	ק אַ פּ
קאַפּיטל	ק אַ פּ י ט ל
קאַפּיטאַלן	ק אַ פּ י ט אַ ל נ
קאַפּיטאַן	ק אַ פּ י ט אַ נ
קאַפּלעך	ק אַ פּ ל ע כ
קאַפּען	ק אַ פּ ע נ
קאַפּריז	ק אַ פּ ר י ז
קאַפּױער	ק אַ פּ ױ ע ר
קאַפּאָטע	ק אַ פּ אָ ט ע
קאַפּאָטעס	ק אַ פּ אָ ט ע ס
קאַפּאָטקעלעך	ק אַ פּ אָ ט ק ע ל ע כ
קאַפּאָרע	ק אַ פּ אָ ר ע
קאַפּאָרעס	ק אַ פּ אָ ר ע ס
קאַפֿטן	ק אַ פֿ ט נ
קאַפֿטנדל	ק אַ פֿ ט נ ד ל
קאַפֿעשאַ	ק אַ פֿ ע ש אַ
קאָזמער	ק אָ ז מ ע ר
קאָזמערער	ק אָ ז מ ע ר ע ר
קאָזעק	ק אָ ז ע ק
קאָטער	ק אָ ט ע ר
קאָטש	ק אָ ט ש
קאָכט	ק אָ כ ט
קאָכן	ק אָ כ נ
קאָל	ק אָ ל
קאָל־האַטױרע	ק אָ ל ה אַ ט ױ ר ע
קאָל־האַשװוּעס	ק אָ ל ה אַ ש װ וּ ע ס
קאָל־האַשװוּעס־שעבאָױלעם	ק אָ ל ה אַ ש װ וּ ע ס ש ע ב אָ ױ ל ע מ
קאָל־טױרע	ק אָ ל ט ױ ר ע
קאָל־טוּװ	ק אָ ל ט וּ װ
קאָל־ייִסראָעל	ק אָ ל י יִ ס ר אָ ע ל
קאָל־יאָמעװ	ק אָ ל י אָ מ ע װ
קאָל־נעגינע	ק אָ ל נ ע ג י נ ע
קאָלדרע	ק אָ ל ד ר ע
קאָלדרעס	ק אָ ל ד ר ע ס
קאָלזמאַן	ק אָ ל ז מ אַ נ
קאָליר	ק אָ ל י ר
קאָלירטע	ק אָ ל י ר ט ע
קאָלירן	ק אָ ל י ר נ
קאָלנידרע	ק אָ ל נ י ד ר ע
קאָלנער	ק אָ ל נ ע ר
קאָלנערס	ק אָ ל נ ע ר ס
קאָלאַמינים	ק אָ ל אַ מ י נ י מ
קאָמיסיאָנער	ק אָ מ י ס י אָ נ ע ר
קאָמיש	ק אָ מ י ש
קאָמאַ	ק אָ מ אַ
קאָמפּלימענטן	ק אָ מ פּ ל י מ ע נ ט נ
קאָמפּראָמיס	ק אָ מ פּ ר אָ מ י ס
קאָן	ק אָ נ
קאָנגעלט	ק אָ נ ג ע ל ט
קאָנגרעס־לײַט	ק אָ נ ג ר ע ס ל ײַ ט
קאָנט	ק אָ נ ט
קאָנטערבאַס	ק אָ נ ט ע ר ב אַ ס
קאָנטראַקט	ק אָ נ ט ר אַ ק ט
קאָנטראַקטן	ק אָ נ ט ר אַ ק ט נ
קאָננע	ק אָ נ נ ע
קאָנסט	ק אָ נ ס ט
קאָנסטיטוציע	ק אָ נ ס ט י ט ו צ י ע
קאָנסקער	ק אָ נ ס ק ע ר
קאָנסקעװאָליער	ק אָ נ ס ק ע װ אָ ל י ע ר
קאָנען	ק אָ נ ע נ
קאָנװערט	ק אָ נ װ ע ר ט
קאָנפֿערענץ	ק אָ נ פֿ ע ר ע נ צ
קאָסט	ק אָ ס ט
קאָסטן	ק אָ ס ט נ
קאָרבן־מינכע	ק אָ ר ב נ מ י נ כ ע
קאָרטן	ק אָ ר ט נ
קאָרטאָנע	ק אָ ר ט אָ נ ע
קאָרידאָר	ק אָ ר י ד אָ ר
קאָרן	ק אָ ר נ
קאָרע	ק אָ ר ע
קאָרשל	ק אָ ר ש ל
קאָרפּוס	ק אָ ר פּ ו ס
קאָשערע	ק אָ ש ע ר ע
קאָשערער	ק אָ ש ע ר ע ר
קאָװעד	ק אָ װ ע ד
קאָאָל	ק אָ אָ ל
קאָפּ	ק אָ פּ
קאָפּיקע	ק אָ פּ י ק ע
קאָפּיקעס	ק אָ פּ י ק ע ס
קאָפּל	ק אָ פּ ל
קאָפּעקעס	ק אָ פּ ע ק ע ס
קאָפּקעס	ק אָ פּ ק ע ס
קאָפֿטל	ק אָ פֿ ט ל
רו	ר ו
רובל	ר ו ב ל
רובלדיקן	ר ו ב ל ד י ק נ
רוגזע	ר ו ג ז ע
רודער	ר ו ד ע ר
רודערן	ר ו ד ע ר נ
רוט	ר ו ט
רוכעס	ר ו כ ע ס
רוכאַניִעס	ר ו כ אַ נ יִ ע ס
רונדיק	ר ו נ ד י ק
רונדיקע	ר ו נ ד י ק ע
רונדן	ר ו נ ד נ
רוסיש	ר ו ס י ש
רוסישע	ר ו ס י ש ע
רועך	ר ו ע כ
רוען	ר ו ע נ
רוף	ר ו פֿ
רוק	ר ו ק
רוקט	ר ו ק ט
רוקן	ר ו ק נ
רוקנס	ר ו ק נ ס
רויִק	ר ו יִ ק
רויִקן	ר ו יִ ק נ
רויִקע	ר ו יִ ק ע
רויִקײט	ר ו יִ ק ײ ט
רופֿט	ר ו פֿ ט
רופֿן	ר ו פֿ נ
ריגאָשי	ר י ג אָ ש י
ריזיק	ר י ז י ק
ריזיקן	ר י ז י ק נ
ריזן	ר י ז נ
ריטלעך	ר י ט ל ע כ
ריטשן	ר י ט ש נ
ריכטיקן	ר י כ ט י ק נ
ריכטיקע	ר י כ ט י ק ע
ריכטן	ר י כ ט נ
רינגלט	ר י נ ג ל ט
רינגלען	ר י נ ג ל ע נ
רינד	ר י נ ד
רינט	ר י נ ט
רינע	ר י נ ע
רינען	ר י נ ע נ
ריס	ר י ס
ריר	ר י ר
רירט	ר י ר ט
רירן	ר י ר נ
ריפּ־סקריפּ	ר י פּ ס ק ר י פּ
רעב	ר ע ב
רעבם	ר ע ב מ
רעבמס	ר ע ב מ ס
רעבע	ר ע ב ע
רעבעס	ר ע ב ע ס
רעבעצן	ר ע ב ע צ נ
רעבעצנס	ר ע ב ע צ נ ס
רעבױנע־שעלױלעם	ר ע ב ױ נ ע ש ע ל ױ ל ע מ
רעגילעס	ר ע ג י ל ע ס
רעגל	ר ע ג ל
רעגן	ר ע ג נ
רעגע	ר ע ג ע
רעד	ר ע ד
רעדט	ר ע ד ט
רעדל	ר ע ד ל
רעדלט	ר ע ד ל ט
רעדלעך	ר ע ד ל ע כ
רעדן	ר ע ד נ
רעדנדיק	ר ע ד נ ד י ק
רעדסטו	ר ע ד ס ט ו
רעדער	ר ע ד ע ר
רעזשיסאָר	ר ע ז ש י ס אָ ר
רעטעכער	ר ע ט ע כ ע ר
רעטאָריק	ר ע ט אָ ר י ק
רעין	ר ע י נ
רעכט	ר ע כ ט
רעכטן	ר ע כ ט נ
רעכטס	ר ע כ ט ס
רעכטע	ר ע כ ט ע
רעכטער	ר ע כ ט ע ר
רעכן	ר ע כ נ
רעכן־מײַסטער	ר ע כ נ מ ײַ ס ט ע ר
רעכן־מײַסטערס	ר ע כ נ מ ײַ ס ט ע ר ס
רעכנט	ר ע כ נ ט
רעכענונג	ר ע כ ע נ ו נ ג
רעכענונגען	ר ע כ ע נ ו נ ג ע נ
רעכענען	ר ע כ ע נ ע נ
רעציכעדיק	ר ע צ י כ ע ד י ק
רעצעפּט	ר ע צ ע פּ ט
רעצעפּטן	ר ע צ ע פּ ט נ
רעצײעך	ר ע צ ײ ע כ
רעקל	ר ע ק ל
רעשוס	ר ע ש ו ס
רעשוס־האָראַבים	ר ע ש ו ס ה אָ ר אַ ב י מ
רעשטל	ר ע ש ט ל
רעשכױדעש	ר ע ש כ ױ ד ע ש
רעשכױדעש־רעטעכלעך	ר ע ש כ ױ ד ע ש ר ע ט ע כ ל ע כ
רעשאָיִם	ר ע ש אָ יִ מ
רעװאָכים	ר ע װ אָ כ י מ
רעװאָלוציע	ר ע װ אָ ל ו צ י ע
רעװאָלוציעס	ר ע װ אָ ל ו צ י ע ס
רעאַביליטירן	ר ע אַ ב י ל י ט י ר נ
רעאַליזם	ר ע אַ ל י ז מ
רעפּובליקאַנישע	ר ע פּ ו ב ל י ק אַ נ י ש ע
רעפֿוע	ר ע פֿ ו ע
רעפֿועס	ר ע פֿ ו ע ס
רױז	ר ױ ז
רױזיקע	ר ױ ז י ק ע
רױט	ר ױ ט
רױט־ברענענדיקע	ר ױ ט ב ר ע נ ע נ ד י ק ע
רױטבלױען	ר ױ ט ב ל ױ ע נ
רױטהאָריקע	ר ױ ט ה אָ ר י ק ע
רױטינקע	ר ױ ט י נ ק ע
רױטלט	ר ױ ט ל ט
רױטלעכע	ר ױ ט ל ע כ ע
רױטלעכער	ר ױ ט ל ע כ ע ר
רױטלעכקײט	ר ױ ט ל ע כ ק ײ ט
רױטן	ר ױ ט נ
רױטע	ר ױ ט ע
רױטער	ר ױ ט ע ר
רױטשילד	ר ױ ט ש י ל ד
רױטשילדס	ר ױ ט ש י ל ד ס
רױך	ר ױ כ
רױכיקע	ר ױ כ י ק ע
רױכער	ר ױ כ ע ר
רױכערט	ר ױ כ ע ר ט
רױכערן	ר ױ כ ע ר נ
רױמט	ר ױ מ ט
רױשט	ר ױ ש ט
רױפֿע	ר ױ פֿ ע
רױפֿעטע	ר ױ פֿ ע ט ע
רױפֿעטעס	ר ױ פֿ ע ט ע ס
רױפֿעס	ר ױ פֿ ע ס
רײד	ר ײ ד
רײדן	ר ײ ד נ
רײדנדיק	ר ײ ד נ ד י ק
רײזען	ר ײ ז ע נ
רײכעס	ר ײ כ ע ס
רײכערן	ר ײ כ ע ר נ
רײן	ר ײ נ
רײנע	ר ײ נ ע
רײנעם	ר ײ נ ע מ
רײעך	ר ײ ע כ
רײען	ר ײ ע נ
רײף	ר ײ פֿ
רײצט	ר ײ צ ט
רײצן	ר ײ צ נ
רײש	ר ײ ש
רײַבט	ר ײַ ב ט
רײַבן	ר ײַ ב נ
רײַבעניש	ר ײַ ב ע נ י ש
רײַך	ר ײַ כ
רײַכן	ר ײַ כ נ
רײַכע	ר ײַ כ ע
רײַכער	ר ײַ כ ע ר
רײַס	ר ײַ ס
רײַסט	ר ײַ ס ט
רײַסן	ר ײַ ס נ
רײַע	ר ײַ ע
ראַ	ר אַ
ראַבעטיני	ר אַ ב ע ט י נ י
ראַבעס	ר אַ ב ע ס
ראַבױסים	ר אַ ב ױ ס י מ
ראַבױסײַ	ר אַ ב ױ ס ײַ
ראַבײנע	ר אַ ב ײ נ ע
ראַבײַ	ר אַ ב ײַ
ראַבאָ	ר אַ ב אָ
ראַבאָנים	ר אַ ב אָ נ י מ
ראַבאָנען־קאַדעש	ר אַ ב אָ נ ע נ ק אַ ד ע ש
ראַגלאַיִם	ר אַ ג ל אַ יִ מ
ראַדאָמישל	ר אַ ד אָ מ י ש ל
ראַזעװע	ר אַ ז ע װ ע
ראַטעװעט	ר אַ ט ע װ ע ט
ראַטעװען	ר אַ ט ע װ ע נ
ראַכמים	ר אַ כ מ י מ
ראַכמאָנע־ליצלאַן	ר אַ כ מ אָ נ ע ל י צ ל אַ נ
ראַכמאָנעס	ר אַ כ מ אָ נ ע ס
ראַכװעסדיקײט	ר אַ כ װ ע ס ד י ק ײ ט
ראַם־באָם	ר אַ מ ב אָ מ
ראַמבאַם	ר אַ מ ב אַ מ
ראַנד	ר אַ נ ד
ראַספּוטין	ר אַ ס פּ ו ט י נ
ראַספּוטינען	ר אַ ס פּ ו ט י נ ע נ
ראַש	ר אַ ש
ראַשן	ר אַ ש נ
ראַשע	ר אַ ש ע
ראַשעדיק	ר אַ ש ע ד י ק
ראָ־	ר אָ
ראָבן	ר אָ ב נ
ראָד	ר אָ ד
ראָוז	ר אָ ו ז
ראָוזן	ר אָ ו ז נ
ראָזנקראַנץ	ר אָ ז נ ק ר אַ נ צ
ראָזשינקע	ר אָ ז ש י נ ק ע
ראָזשינקעס	ר אָ ז ש י נ ק ע ס
ראָזשינקעס־װײַן	ר אָ ז ש י נ ק ע ס װ ײַ נ
ראָכל־לײע	ר אָ כ ל ל ײ ע
ראָלע	ר אָ ל ע
ראָמאַנען	ר אָ מ אַ נ ע נ
ראָנדל	ר אָ נ ד ל
ראָע	ר אָ ע
ראָצכים	ר אָ צ כ י מ
ראָצן	ר אָ צ נ
ראָק	ר אָ ק
ראָש־האַמעדבאָרים	ר אָ ש ה אַ מ ע ד ב אָ ר י מ
ראָשעשאָנע	ר אָ ש ע ש אָ נ ע
ראָשײטע	ר אָ ש ײ ט ע
ראָװ	ר אָ װ
ראָװס	ר אָ װ ס
רוּװן	ר וּ װ נ
שו־	ש ו
שוטעף	ש ו ט ע פֿ
שוטפֿים	ש ו ט פֿ י מ
שוטפֿעס	ש ו ט פֿ ע ס
שול	ש ו ל
שולגעסל	ש ו ל ג ע ס ל
שולדיק	ש ו ל ד י ק
שולכן־אָרעך	ש ו ל כ נ אָ ר ע כ
שולן	ש ו ל נ
שום	ש ו מ
שונד	ש ו נ ד
שוסטער	ש ו ס ט ע ר
שוסטערס	ש ו ס ט ע ר ס
שוץ	ש ו צ
שופֿלאָדל	ש ו פֿ ל אָ ד ל
שטוב	ש ט ו ב
שטוב־װאַרעמקײט	ש ט ו ב װ אַ ר ע מ ק ײ ט
שטובזאַכן	ש ט ו ב ז אַ כ נ
שטובמענטשן	ש ט ו ב מ ע נ ט ש נ
שטודירן	ש ט ו ד י ר נ
שטול	ש ט ו ל
שטולן	ש ט ו ל נ
שטום	ש ט ו מ
שטומע	ש ט ו מ ע
שטומען	ש ט ו מ ע נ
שטומער	ש ט ו מ ע ר
שטומפּיק	ש ט ו מ פּ י ק
שטורקאַצן	ש ט ו ר ק אַ צ נ
שטופּ	ש ט ו פּ
שטופּט	ש ט ו פּ ט
שטופּן	ש ט ו פּ נ
שטיבל	ש ט י ב ל
שטיבער	ש ט י ב ע ר
שטיל	ש ט י ל
שטיל־שװײַגנדיק	ש ט י ל ש װ ײַ ג נ ד י ק
שטיל־פֿאַרטרונקענער	ש ט י ל פֿ אַ ר ט ר ו נ ק ע נ ע ר
שטילן	ש ט י ל נ
שטילע	ש ט י ל ע
שטילעניש	ש ט י ל ע נ י ש
שטילער	ש ט י ל ע ר
שטילערהײט	ש ט י ל ע ר ה ײ ט
שטילשװײַגן	ש ט י ל ש װ ײַ ג נ
שטילשװײַגנדיק	ש ט י ל ש װ ײַ ג נ ד י ק
שטילשװײַגעניש	ש ט י ל ש װ ײַ ג ע נ י ש
שטים	ש ט י מ
שטימט	ש ט י מ ט
שטימע	ש ט י מ ע
שטימען	ש ט י מ ע נ
שטיק	ש ט י ק
שטיקל	ש ט י ק ל
שטיקלעך	ש ט י ק ל ע כ
שטיקלעכװײַז	ש ט י ק ל ע כ װ ײַ ז
שטיקן	ש ט י ק נ
שטיקער	ש ט י ק ע ר
שטיװל	ש ט י װ ל
שטיװלעטן	ש ט י װ ל ע ט נ
שטיװעלעך	ש ט י װ ע ל ע כ
שטיפֿמאַמע	ש ט י פֿ מ אַ מ ע
שטעגעלעך	ש ט ע ג ע ל ע כ
שטעט	ש ט ע ט
שטעטל	ש ט ע ט ל
שטעכט	ש ט ע כ ט
שטעכלדיקע	ש ט ע כ ל ד י ק ע
שטעכלקעס	ש ט ע כ ל ק ע ס
שטעכן	ש ט ע כ נ
שטעכנדיק	ש ט ע כ נ ד י ק
שטעכעלקעס	ש ט ע כ ע ל ק ע ס
שטעכעניש	ש ט ע כ ע נ י ש
שטעכװערטער	ש ט ע כ װ ע ר ט ע ר
שטעל	ש ט ע ל
שטעלט	ש ט ע ל ט
שטעלן	ש ט ע ל נ
שטעלע	ש ט ע ל ע
שטעלעכל	ש ט ע ל ע כ ל
שטענדיק	ש ט ע נ ד י ק
שטענדער	ש ט ע נ ד ע ר
שטעק	ש ט ע ק
שטעקט	ש ט ע ק ט
שטעקל	ש ט ע ק ל
שטעקן	ש ט ע ק נ
שטעקנס	ש ט ע ק נ ס
שטעקשיך	ש ט ע ק ש י כ
שטערט	ש ט ע ר ט
שטערן	ש ט ע ר נ
שטערן־טיכלעך	ש ט ע ר נ ט י כ ל ע כ
שטערנס	ש ט ע ר נ ס
שטרודלען	ש ט ר ו ד ל ע נ
שטריק	ש ט ר י ק
שטריקל	ש ט ר י ק ל
שטריקן	ש ט ר י ק נ
שטריקנאָדלען	ש ט ר י ק נ אָ ד ל ע נ
שטריקאַװעס	ש ט ר י ק אַ װ ע ס
שטרענג	ש ט ר ע נ ג
שטרעק	ש ט ר ע ק
שטרעקט	ש ט ר ע ק ט
שטרױ	ש ט ר ױ
שטרײַמל	ש ט ר ײַ מ ל
שטראַל	ש ט ר אַ ל
שטראַלן	ש ט ר אַ ל נ
שטראָם	ש ט ר אָ מ
שטראָמט	ש ט ר אָ מ ט
שטראָמיק	ש ט ר אָ מ י ק
שטראָמען	ש ט ר אָ מ ע נ
שטראָמענדיק	ש ט ר אָ מ ע נ ד י ק
שטראָף	ש ט ר אָ פֿ
שטראָפֿן	ש ט ר אָ פֿ נ
שטױב	ש ט ױ ב
שטױבעלע	ש ט ױ ב ע ל ע
שטױסל	ש ט ױ ס ל
שטױסן	ש ט ױ ס נ
שטײ	ש ט ײ
שטײגער	ש ט ײ ג ע ר
שטײט	ש ט ײ ט
שטײן	ש ט ײ נ
שטײנער	ש ט ײ נ ע ר
שטײען	ש ט ײ ע נ
שטײענדיק	ש ט ײ ע נ ד י ק
שטײענדיקע	ש ט ײ ע נ ד י ק ע
שטײַגן	ש ט ײַ ג נ
שטײַף	ש ט ײַ פֿ
שטאַל	ש ט אַ ל
שטאַלן	ש ט אַ ל נ
שטאַנד	ש ט אַ נ ד
שטאַרב	ש ט אַ ר ב
שטאַרבן	ש ט אַ ר ב נ
שטאַרט	ש ט אַ ר ט
שטאַרצן	ש ט אַ ר צ נ
שטאַרק	ש ט אַ ר ק
שטאַרקן	ש ט אַ ר ק נ
שטאַרקע	ש ט אַ ר ק ע
שטאַרקער	ש ט אַ ר ק ע ר
שטאָט	ש ט אָ ט
שטאָט־באַלעבאַטים	ש ט אָ ט ב אַ ל ע ב אַ ט י מ
שטאָט־באַלעבאָס	ש ט אָ ט ב אַ ל ע ב אָ ס
שטאָט־באַלעבאָסטע	ש ט אָ ט ב אַ ל ע ב אָ ס ט ע
שטאָט־ראָװ	ש ט אָ ט ר אָ װ
שטאָטבערזע	ש ט אָ ט ב ע ר ז ע
שטאָטגלאָק	ש ט אָ ט ג ל אָ ק
שטאָטגעסל	ש ט אָ ט ג ע ס ל
שטאָטישע	ש ט אָ ט י ש ע
שטאָטס	ש ט אָ ט ס
שטאָטשטוב	ש ט אָ ט ש ט ו ב
שטאָך	ש ט אָ כ
שטאָל	ש ט אָ ל
שטאָלט	ש ט אָ ל ט
שטאָלץ	ש ט אָ ל צ
שטאָפּן	ש ט אָ פּ נ
שידוכים	ש י ד ו כ י מ
שידעך	ש י ד ע כ
שיט	ש י ט
שיטן	ש י ט נ
שיטער	ש י ט ע ר
שיטערע	ש י ט ע ר ע
שיטערער	ש י ט ע ר ע ר
שיך	ש י כ
שילד	ש י ל ד
שילדער	ש י ל ד ע ר
שילטן	ש י ל ט נ
שימו	ש י מ ו
שימכעם	ש י מ כ ע מ
שימל	ש י מ ל
שימענעסרע	ש י מ ע נ ע ס ר ע
שימערט	ש י מ ע ר ט
שין	ש י נ
שיסט	ש י ס ט
שיסל	ש י ס ל
שיף	ש י פֿ
שיצט	ש י צ ט
שיקורים	ש י ק ו ר י מ
שיקט	ש י ק ט
שיקן	ש י ק נ
שיקער	ש י ק ע ר
שיקערערהײט	ש י ק ע ר ע ר ה ײ ט
שיר	ש י ר
שיר־אַשירים	ש י ר אַ ש י ר י מ
שירץ	ש י ר צ
שירצלעך	ש י ר צ ל ע כ
שירצן	ש י ר צ נ
שיראַיִם	ש י ר אַ יִ מ
שישים	ש י ש י מ
שישיס־יאַמי־ברײשעס	ש י ש י ס י אַ מ י ב ר ײ ש ע ס
שישקעס	ש י ש ק ע ס
שיפֿל	ש י פֿ ל
שכינע	ש כ י נ ע
שכײנע	ש כ ײ נ ע
שכײנעס	ש כ ײ נ ע ס
שליטן	ש ל י ט נ
שליכעס	ש ל י כ ע ס
שלימ־שלימאַזל	ש ל י מ ש ל י מ אַ ז ל
שלימאַזל	ש ל י מ אַ ז ל
שלינג	ש ל י נ ג
שלינגט	ש ל י נ ג ט
שלינגען	ש ל י נ ג ע נ
שליסל	ש ל י ס ל
שליסלעך	ש ל י ס ל ע כ
שלעכט	ש ל ע כ ט
שלעכטס	ש ל ע כ ט ס
שלעכטע	ש ל ע כ ט ע
שלעכטער	ש ל ע כ ט ע ר
שלעק	ש ל ע ק
שלעפּט	ש ל ע פּ ט
שלעפּן	ש ל ע פּ נ
שלעפּנדיק	ש ל ע פּ נ ד י ק
שלױמע	ש ל ױ מ ע
שלײער	ש ל ײ ע ר
שלײערס	ש ל ײ ע ר ס
שלײפֿן	ש ל ײ פֿ נ
שלאַכטפֿעלד	ש ל אַ כ ט פֿ ע ל ד
שלאַנג	ש ל אַ נ ג
שלאַנגען	ש ל אַ נ ג ע נ
שלאַנק	ש ל אַ נ ק
שלאַפֿקײט	ש ל אַ פֿ ק ײ ט
שלאַפֿקײטן	ש ל אַ פֿ ק ײ ט נ
שלאָגט	ש ל אָ ג ט
שלאָגן	ש ל אָ ג נ
שלאָגסטו	ש ל אָ ג ס ט ו
שלאָף	ש ל אָ פֿ
שלאָפֿט	ש ל אָ פֿ ט
שלאָפֿן	ש ל אָ פֿ נ
שלאָפֿראָק	ש ל אָ פֿ ר אָ ק
שמועס	ש מ ו ע ס
שמועסט	ש מ ו ע ס ט
שמועסן	ש מ ו ע ס נ
שמועסנדיק	ש מ ו ע ס נ ד י ק
שמיץ	ש מ י צ
שמיר־מיט־פּוטער	ש מ י ר מ י ט פּ ו ט ע ר
שמירט	ש מ י ר ט
שמעמעס	ש מ ע מ ע ס
שמעק	ש מ ע ק
שמעקט	ש מ ע ק ט
שמעקן	ש מ ע ק נ
שמעקנדיק	ש מ ע ק נ ד י ק
שמעקנדיקע	ש מ ע ק נ ד י ק ע
שמעקעדיקע	ש מ ע ק ע ד י ק ע
שמױגער	ש מ ױ ג ע ר
שמײ	ש מ ײ
שמײ־ראַבאָ	ש מ ײ ר אַ ב אָ
שמײכל	ש מ ײ כ ל
שמײכלט	ש מ ײ כ ל ט
שמײכלענדיקע	ש מ ײ כ ל ע נ ד י ק ע
שמײכעלע	ש מ ײ כ ע ל ע
שמײַסט	ש מ ײַ ס ט
שמײַסן	ש מ ײַ ס נ
שמײַסער	ש מ ײַ ס ע ר
שמאַ־ייִסראָעל	ש מ אַ י יִ ס ר אָ ע ל
שמאַטע	ש מ אַ ט ע
שמאַטעס	ש מ אַ ט ע ס
שמאַלץ	ש מ אַ ל צ
שמאַלצגרוב	ש מ אַ ל צ ג ר ו ב
שמאָל	ש מ אָ ל
שמאָלע	ש מ אָ ל ע
שנור	ש נ ו ר
שנורס	ש נ ו ר ס
שנופּטיכלעך	ש נ ו פּ ט י כ ל ע כ
שניטרעק	ש נ י ט ר ע ק
שניר	ש נ י ר
שניפּס	ש נ י פּ ס
שניפּסל	ש נ י פּ ס ל
שנעל	ש נ ע ל
שנעלט	ש נ ע ל ט
שנױצן	ש נ ױ צ נ
שנײ	ש נ ײ
שנײ־בױמעלעך	ש נ ײ ב ױ מ ע ל ע כ
שנײדעק	ש נ ײ ד ע ק
שנײענדיקער	ש נ ײ ע נ ד י ק ע ר
שנײװעלט	ש נ ײ װ ע ל ט
שנײַד	ש נ ײַ ד
שנײַדט	ש נ ײַ ד ט
שנײַדן	ש נ ײַ ד נ
שנײַדער	ש נ ײַ ד ע ר
שנײַדעריונג	ש נ ײַ ד ע ר י ו נ ג
שנײַדערין	ש נ ײַ ד ע ר י נ
שנײַדערישע	ש נ ײַ ד ע ר י ש ע
שנײַדערישער	ש נ ײַ ד ע ר י ש ע ר
שנײַדערס	ש נ ײַ ד ע ר ס
שנאָרכן	ש נ אָ ר כ נ
שעבע	ש ע ב ע
שעבעבלאָטע	ש ע ב ע ב ל אָ ט ע
שעבעשמאַטע	ש ע ב ע ש מ אַ ט ע
שעבאָױלעם	ש ע ב אָ ױ ל ע מ
שעכעיאָנו	ש ע כ ע י אָ נ ו
שעל	ש ע ל
שעלט	ש ע ל ט
שעלמיש	ש ע ל מ י ש
שעליִעך־ציבער	ש ע ל יִ ע כ צ י ב ע ר
שעם	ש ע מ
שעמט	ש ע מ ט
שעמען	ש ע מ ע נ
שעמעניץ	ש ע מ ע נ י צ
שעמעניצער	ש ע מ ע נ י צ ע ר
שענסטע	ש ע נ ס ט ע
שענער	ש ע נ ע ר
שענק	ש ע נ ק
שענקען	ש ע נ ק ע נ
שעקער־װעקאָזעװ	ש ע ק ע ר װ ע ק אָ ז ע װ
שערענגע	ש ע ר ע נ ג ע
שערעצקע	ש ע ר ע צ ק ע
שעפּס	ש ע פּ ס
שעפּסן	ש ע פּ ס נ
שעפֿע	ש ע פֿ ע
שעפֿער	ש ע פֿ ע ר
שקאָצים	ש ק אָ צ י מ
שריפֿטן	ש ר י פֿ ט נ
שרעק	ש ר ע ק
שרעקט	ש ר ע ק ט
שרעקלעך	ש ר ע ק ל ע כ
שרעקן	ש ר ע ק נ
שרײַב	ש ר ײַ ב
שרײַבט	ש ר ײַ ב ט
שרײַבטיש	ש ר ײַ ב ט י ש
שרײַבן	ש ר ײַ ב נ
שרײַבער	ש ר ײַ ב ע ר
שרײַבערל	ש ר ײַ ב ע ר ל
שרײַט	ש ר ײַ ט
שרײַען	ש ר ײַ ע נ
שראַנק	ש ר אַ נ ק
שראַנקען	ש ר אַ נ ק ע נ
שװיגער	ש װ י ג ע ר
שװיגערס	ש װ י ג ע ר ס
שװים	ש װ י מ
שװימט	ש װ י מ ט
שװימען	ש װ י מ ע נ
שװינדלענדיקער	ש װ י נ ד ל ע נ ד י ק ע ר
שװינדלער	ש װ י נ ד ל ע ר
שװיצט	ש װ י צ ט
שװיצן	ש װ י צ נ
שװעבל	ש װ ע ב ל
שװעבן	ש װ ע ב נ
שװעגערין	ש װ ע ג ע ר י נ
שװעל	ש װ ע ל
שװעלן	ש װ ע ל נ
שװעמלעך	ש װ ע מ ל ע כ
שװעסטער	ש װ ע ס ט ע ר
שװעסטערל	ש װ ע ס ט ע ר ל
שװעסטערלעך	ש װ ע ס ט ע ר ל ע כ
שװעסטערקינד	ש װ ע ס ט ע ר ק י נ ד
שװעסטערקינדער	ש װ ע ס ט ע ר ק י נ ד ע ר
שװער	ש װ ע ר
שװערדן	ש װ ע ר ד נ
שװערט	ש װ ע ר ט
שװערינקע	ש װ ע ר י נ ק ע
שװערלעך	ש װ ע ר ל ע כ
שװערן	ש װ ע ר נ
שװערסטע	ש װ ע ר ס ט ע
שװערסטער	ש װ ע ר ס ט ע ר
שװערע	ש װ ע ר ע
שװערער	ש װ ע ר ע ר
שװערערס	ש װ ע ר ע ר ס
שװײס	ש װ ײ ס
שװײַג	ש װ ײַ ג
שװײַגט	ש װ ײַ ג ט
שװײַגן	ש װ ײַ ג נ
שװײַגנדיק	ש װ ײַ ג נ ד י ק
שװײַגס	ש װ ײַ ג ס
שװאַט	ש װ אַ ט
שװאַך	ש װ אַ כ
שװאַכער	ש װ אַ כ ע ר
שװאַרץ	ש װ אַ ר צ
שװאַרצט	ש װ אַ ר צ ט
שװאַרצן	ש װ אַ ר צ נ
שװאַרצס	ש װ אַ ר צ ס
שװאַרצע	ש װ אַ ר צ ע
שװאַרצער	ש װ אַ ר צ ע ר
שװאָגער	ש װ אָ ג ע ר
שװאָגערס	ש װ אָ ג ע ר ס
שװוּע־דעױרײַסע	ש װ וּ ע ד ע ױ ר ײַ ס ע
שװוּעס	ש װ וּ ע ס
שױב	ש ױ ב
שױבן	ש ױ ב נ
שױבן־שענקל	ש ױ ב נ ש ע נ ק ל
שױכעט	ש ױ כ ע ט
שױכעטס	ש ױ כ ע ט ס
שױכעטקע	ש ױ כ ע ט ק ע
שױם	ש ױ מ
שױמער־אומאַצל	ש ױ מ ע ר ו מ אַ צ ל
שױמער־װע־מאַצל	ש ױ מ ע ר װ ע מ אַ צ ל
שױן	ש ױ נ
שױס	ש ױ ס
שױרעש	ש ױ ר ע ש
שױשאַנעס־יאַנקעװ	ש ױ ש אַ נ ע ס י אַ נ ק ע װ
שױפֿער	ש ױ פֿ ע ר
שײגעץ	ש ײ ג ע צ
שײד	ש ײ ד
שײדט	ש ײ ד ט
שײדים	ש ײ ד י מ
שײטל	ש ײ ט ל
שײטלעך	ש ײ ט ל ע כ
שײטלען	ש ײ ט ל ע נ
שײלט	ש ײ ל ט
שײמעס	ש ײ מ ע ס
שײן	ש ײ נ
שײנס	ש ײ נ ס
שײנע	ש ײ נ ע
שײנעם	ש ײ נ ע מ
שײנער	ש ײ נ ע ר
שײשעס־יעמײ־ברײשעס	ש ײ ש ע ס י ע מ ײ ב ר ײ ש ע ס
שיִעס	ש יִ ע ס
שיִער	ש יִ ע ר
שײַטלעך	ש ײַ ט ל ע כ
שײַכעס	ש ײַ כ ע ס
שײַלע	ש ײַ ל ע
שײַן	ש ײַ נ
שײַנט	ש ײַ נ ט
שײַנענדיקער	ש ײַ נ ע נ ד י ק ע ר
שײַעך	ש ײַ ע כ
שאַ	ש אַ
שאַבעס	ש אַ ב ע ס
שאַבעס־האַגאָדל	ש אַ ב ע ס ה אַ ג אָ ד ל
שאַבעס־לאָבוסעס	ש אַ ב ע ס ל אָ ב ו ס ע ס
שאַבעס־מאַלקע־כײן	ש אַ ב ע ס מ אַ ל ק ע כ ײ נ
שאַבעס־נאַכמו	ש אַ ב ע ס נ אַ כ מ ו
שאַבעסדיק	ש אַ ב ע ס ד י ק
שאַבעסדיקע	ש אַ ב ע ס ד י ק ע
שאַבאָסים	ש אַ ב אָ ס י מ
שאַדט	ש אַ ד ט
שאַט	ש אַ ט
שאַט־שאַט	ש אַ ט ש אַ ט
שאַטכן	ש אַ ט כ נ
שאַך	ש אַ כ
שאַל	ש אַ ל
שאַלן	ש אַ ל נ
שאַלעמױזן	ש אַ ל ע מ ױ ז נ
שאַמעס	ש אַ מ ע ס
שאַנק	ש אַ נ ק
שאַס	ש אַ ס
שאַר	ש אַ ר
שאַרט	ש אַ ר ט
שאַרן	ש אַ ר נ
שאַרנדיקע	ש אַ ר נ ד י ק ע
שאַרף	ש אַ ר פֿ
שאַרפֿן	ש אַ ר פֿ נ
שאַרפֿע	ש אַ ר פֿ ע
שאַרפֿער	ש אַ ר פֿ ע ר
שאַפֿן	ש אַ פֿ נ
שאַפֿע	ש אַ פֿ ע
שאָ	ש אָ
שאָד	ש אָ ד
שאָדן	ש אָ ד נ
שאָטן	ש אָ ט נ
שאָטנס	ש אָ ט נ ס
שאָכלינער	ש אָ כ ל י נ ע ר
שאָכן	ש אָ כ נ
שאָכנס	ש אָ כ נ ס
שאָכאַני	ש אָ כ אַ נ י
שאָל	ש אָ ל
שאָלעכץ	ש אָ ל ע כ צ
שאָלעם	ש אָ ל ע מ
שאָלעם־װעשאַלװע	ש אָ ל ע מ װ ע ש אַ ל װ ע
שאָלעם־אַלײכעם	ש אָ ל ע מ אַ ל ײ כ ע מ
שאָלקאָװיצעס	ש אָ ל ק אָ װ י צ ע ס
שאָק	ש אָ ק
שאָקל	ש אָ ק ל
שאָקלט	ש אָ ק ל ט
שאָקלען	ש אָ ק ל ע נ
שאָקאָלאַד־קאָליר	ש אָ ק אָ ל אַ ד ק אָ ל י ר
שאָפּן־פּעלצן	ש אָ פּ נ פּ ע ל צ נ
שאָפּנפּעלץ	ש אָ פּ נ פּ ע ל צ
שאָפּנפֿעלץ	ש אָ פּ נ פֿ ע ל צ
שאָפּענע	ש אָ פּ ע נ ע
שוּװאַקס	ש וּ װ אַ ק ס
שפּורן	ש פּ ו ר נ
שפּיגלט	ש פּ י ג ל ט
שפּיטאָל	ש פּ י ט אָ ל
שפּיטאָלבעט	ש פּ י ט אָ ל ב ע ט
שפּיל	ש פּ י ל
שפּילט	ש פּ י ל ט
שפּילכל	ש פּ י ל כ ל
שפּילן	ש פּ י ל נ
שפּילסט	ש פּ י ל ס ט
שפּילקע	ש פּ י ל ק ע
שפּילשליװער	ש פּ י ל ש ל י װ ע ר
שפּינװעבס	ש פּ י נ װ ע ב ס
שפּיץ	ש פּ י צ
שפּיצל	ש פּ י צ ל
שפּיצן	ש פּ י צ נ
שפּיצעכיקע	ש פּ י צ ע כ י ק ע
שפּעט	ש פּ ע ט
שפּעטער	ש פּ ע ט ע ר
שפּענדלעך	ש פּ ע נ ד ל ע כ
שפּרוך	ש פּ ר ו כ
שפּרונג	ש פּ ר ו נ ג
שפּרינג	ש פּ ר י נ ג
שפּרינגט	ש פּ ר י נ ג ט
שפּרינגען	ש פּ ר י נ ג ע נ
שפּרינזינעס	ש פּ ר י נ ז י נ ע ס
שפּריצט	ש פּ ר י צ ט
שפּרײט	ש פּ ר ײ ט
שפּראָצט	ש פּ ר אָ צ ט
שפּראָצן	ש פּ ר אָ צ נ
שפּראָצנדיקע	ש פּ ר אָ צ נ ד י ק ע
שפּראָצעכץ	ש פּ ר אָ צ ע כ צ
שפּײַ	ש פּ ײַ
שפּײַט	ש פּ ײַ ט
שפּײַכלער	ש פּ ײַ כ ל ע ר
שפּײַען	ש פּ ײַ ע נ
שפּאַלט	ש פּ אַ ל ט
שפּאַלטן	ש פּ אַ ל ט נ
שפּאַניען	ש פּ אַ נ י ע נ
שפּאַנען	ש פּ אַ נ ע נ
שפּאַס	ש פּ אַ ס
שפּאַצירט	ש פּ אַ צ י ר ט
שפּאַצירן	ש פּ אַ צ י ר נ
שפּאַקטיװל	ש פּ אַ ק ט י װ ל
שפּאַר	ש פּ אַ ר
שפּאַרן	ש פּ אַ ר נ
שפּאָגל־נײַע	ש פּ אָ ג ל נ ײַ ע
שפּאָלע	ש פּ אָ ל ע
שפּאָנקעס	ש פּ אָ נ ק ע ס
שפּאָרעװדיקער	ש פּ אָ ר ע װ ד י ק ע ר
שפֿיכעס־דאָמים	ש פֿ י כ ע ס ד אָ מ י מ
װי	װ י
װיג	װ י ג
װיגט	װ י ג ט
װיגל	װ י ג ל
װיגן	װ י ג נ
װידע	װ י ד ע
װידער	װ י ד ע ר
װידערקאָל	װ י ד ע ר ק אָ ל
װיזיט	װ י ז י ט
װיטע	װ י ט ע
װיכטיקן	װ י כ ט י ק נ
װיל	װ י ל
װילד	װ י ל ד
װילד־פֿרעמדער	װ י ל ד פֿ ר ע מ ד ע ר
װילדע	װ י ל ד ע
װילדער	װ י ל ד ע ר
װילט	װ י ל ט
װילן	װ י ל נ
װילנדיק	װ י ל נ ד י ק
װילסט	װ י ל ס ט
װילסטו	װ י ל ס ט ו
װילעדזש	װ י ל ע ד ז ש
װילעדזש־ייִדן	װ י ל ע ד ז ש י יִ ד נ
װימאָראָזיק	װ י מ אָ ר אָ ז י ק
װינד	װ י נ ד
װינט	װ י נ ט
װינטל	װ י נ ט ל
װינטן	װ י נ ט נ
װינטס	װ י נ ט ס
װינטער	װ י נ ט ע ר
װינטערדיק	װ י נ ט ע ר ד י ק
װינטערדיקן	װ י נ ט ע ר ד י ק נ
װינטערדיקע	װ י נ ט ע ר ד י ק ע
װינטערלאָמפּ	װ י נ ט ע ר ל אָ מ פּ
װינטערנאַכט	װ י נ ט ע ר נ אַ כ ט
װינטערצײַט	װ י נ ט ע ר צ ײַ ט
װינטש	װ י נ ט ש
װינטשט	װ י נ ט ש ט
װינטשן	װ י נ ט ש נ
װינטשעװעט	װ י נ ט ש ע װ ע ט
װינציק	װ י נ צ י ק
װינציק־װאָס	װ י נ צ י ק װ אָ ס
װינציקער	װ י נ צ י ק ע ר
װינקט	װ י נ ק ט
װינקל	װ י נ ק ל
װינקלנעזער	װ י נ ק ל נ ע ז ע ר
װינקעלע	װ י נ ק ע ל ע
װינקען	װ י נ ק ע נ
װיסטע	װ י ס ט ע
װיסן	װ י ס נ
װיסנדיק	װ י ס נ ד י ק
װיץ	װ י צ
װיקלען	װ י ק ל ע נ
װירע	װ י ר ע
װירקלעך	װ י ר ק ל ע כ
װיראָבאָװאַ	װ י ר אָ ב אָ װ אַ
װיש	װ י ש
װישט	װ י ש ט
װישניק	װ י ש נ י ק
װיאָרסט	װ י אָ ר ס ט
װיפֿל	װ י פֿ ל
װעג	װ ע ג
װעגט	װ ע ג ט
װעגן	װ ע ג נ
װעדליק	װ ע ד ל י ק
װעהו־ראַכום	װ ע ה ו ר אַ כ ו מ
װעהיװדאַלטעס	װ ע ה י װ ד אַ ל ט ע ס
װעהיװדאַלטאָ	װ ע ה י װ ד אַ ל ט אָ
װעהױע	װ ע ה ױ ע
װעהאַנױרע	װ ע ה אַ נ ױ ר ע
װעהאַקאַלע	װ ע ה אַ ק אַ ל ע
װעהאַשײנעס	װ ע ה אַ ש ײ נ ע ס
װעט	װ ע ט
װעטשערע	װ ע ט ש ע ר ע
װעטאַמליכו	װ ע ט אַ מ ל י כ ו
װעייִסקאַדאַש	װ ע י יִ ס ק אַ ד אַ ש
װעכטער	װ ע כ ט ע ר
װעכאָצי	װ ע כ אָ צ י
װעל	װ ע ל
װעלדל	װ ע ל ד ל
װעלדער	װ ע ל ד ע ר
װעלט	װ ע ל ט
װעלטל	װ ע ל ט ל
װעלטן	װ ע ל ט נ
װעלכן	װ ע ל כ נ
װעלכע	װ ע ל כ ע
װעלכעס	װ ע ל כ ע ס
װעלכער	װ ע ל כ ע ר
װעלן	װ ע ל נ
װעלנדיק	װ ע ל נ ד י ק
װעלף	װ ע ל פֿ
װעלװל	װ ע ל װ ל
װעלװעלער	װ ע ל װ ע ל ע ר
װעלױ	װ ע ל ױ
װעמען	װ ע מ ע נ
װעמענס	װ ע מ ע נ ס
װעמעס	װ ע מ ע ס
װען	װ ע נ
װען־נישט־װען	װ ע נ נ י ש ט װ ע נ
װענדט	װ ע נ ד ט
װענט	װ ע נ ט
װענױמער	װ ע נ ױ מ ע ר
װעסט	װ ע ס ט
װעסטו	װ ע ס ט ו
װעסנע	װ ע ס נ ע
װעעט	װ ע ע ט
װעעס	װ ע ע ס
װעקידאַלטאָ	װ ע ק י ד אַ ל ט אָ
װעקידאַשטאָ	װ ע ק י ד אַ ש ט אָ
װעקן	װ ע ק נ
װעקסל	װ ע ק ס ל
װעקסלען	װ ע ק ס ל ע נ
װער	װ ע ר
װער־װאָס	װ ע ר װ אָ ס
װערט	װ ע ר ט
װערטלעך	װ ע ר ט ל ע כ
װערטעלע	װ ע ר ט ע ל ע
װערטער	װ ע ר ט ע ר
װערי	װ ע ר י
װערן	װ ע ר נ
װערסט	װ ע ר ס ט
װערעם	װ ע ר ע מ
װערעמדיקס	װ ע ר ע מ ד י ק ס
װערצלעך	װ ע ר צ ל ע כ
װערצעלעך	װ ע ר צ ע ל ע כ
װערק	װ ע ר ק
װעש	װ ע ש
װעשואַװי	װ ע ש ו אַ װ י
װעשיראָסאָ	װ ע ש י ר אָ ס אָ
װעשאַל	װ ע ש אַ ל
װעשוּװע	װ ע ש וּ װ ע
װױל	װ ױ ל
װױלטאָן	װ ױ ל ט אָ נ
װױלן	װ ױ ל נ
װױלע	װ ױ ל ע
װױלער	װ ױ ל ע ר
װױלעשע	װ ױ ל ע ש ע
װױנט	װ ױ נ ט
װױנען	װ ױ נ ע נ
װײ	װ ײ
װײ־װײ	װ ײ װ ײ
װײדל	װ ײ ד ל
װײדלעך	װ ײ ד ל ע כ
װײך	װ ײ כ
װײכן	װ ײ כ נ
װײכע	װ ײ כ ע
װײכער	װ ײ כ ע ר
װײן	װ ײ נ
װײנט	װ ײ נ ט
װײניק	װ ײ נ י ק
װײנען	װ ײ נ ע נ
װײנענדיק	װ ײ נ ע נ ד י ק
װײנענדיקן	װ ײ נ ע נ ד י ק נ
װײנענדיקע	װ ײ נ ע נ ד י ק ע
װײס	װ ײ ס
װײסט	װ ײ ס ט
װײסטו	װ ײ ס ט ו
װײסן	װ ײ ס נ
װײעט	װ ײ ע ט
װײען	װ ײ ע נ
װײץ	װ ײ צ
װײצלעך	װ ײ צ ל ע כ
װײַב	װ ײַ ב
װײַבל	װ ײַ ב ל
װײַבלעך	װ ײַ ב ל ע כ
װײַבס	װ ײַ ב ס
װײַבער	װ ײַ ב ע ר
װײַבעריש	װ ײַ ב ע ר י ש
װײַבערישע	װ ײַ ב ע ר י ש ע
װײַבערישער	װ ײַ ב ע ר י ש ע ר
װײַבערשע	װ ײַ ב ע ר ש ע
װײַבערשער	װ ײַ ב ע ר ש ע ר
װײַהי	װ ײַ ה י
װײַז	װ ײַ ז
װײַזט	װ ײַ ז ט
װײַזן	װ ײַ ז נ
װײַט	װ ײַ ט
װײַט־ברענענדיקע	װ ײַ ט ב ר ע נ ע נ ד י ק ע
װײַטן	װ ײַ ט נ
װײַטנס	װ ײַ ט נ ס
װײַטער	װ ײַ ט ע ר
װײַל	װ ײַ ל
װײַלע	װ ײַ ל ע
װײַן	װ ײַ נ
װײַנגאָרטן	װ ײַ נ ג אָ ר ט נ
װײַנטרױבן	װ ײַ נ ט ר ױ ב נ
װײַניק	װ ײַ נ י ק
װײַניקע	װ ײַ נ י ק ע
װײַנשל	װ ײַ נ ש ל
װײַנשעלעך	װ ײַ נ ש ע ל ע כ
װײַנפּערל	װ ײַ נ פּ ע ר ל
װײַנפּערלעך	װ ײַ נ פּ ע ר ל ע כ
װײַס	װ ײַ ס
װײַסל	װ ײַ ס ל
װײַסן	װ ײַ ס נ
װײַסע	װ ײַ ס ע
װײַסער	װ ײַ ס ע ר
װײַסקײט	װ ײַ ס ק ײ ט
װאַגאָן	װ אַ ג אָ נ
װאַייִצמאַך	װ אַ י יִ צ מ אַ כ
װאַלד	װ אַ ל ד
װאַנ	װ אַ נ
װאַנדערער	װ אַ נ ד ע ר ע ר
װאַנדערערס	װ אַ נ ד ע ר ע ר ס
װאַנט	װ אַ נ ט
װאַנעט	װ אַ נ ע ט
װאַנען	װ אַ נ ע נ
װאַסיל	װ אַ ס י ל
װאַסער	װ אַ ס ע ר
װאַסער־גיסן	װ אַ ס ע ר ג י ס נ
װאַסער־גערױש	װ אַ ס ע ר ג ע ר ױ ש
װאַסער־פֿירער	װ אַ ס ע ר פֿ י ר ע ר
װאַסעריק	װ אַ ס ע ר י ק
װאַסערן	װ אַ ס ע ר נ
װאַסערקינד	װ אַ ס ע ר ק י נ ד
װאַסערשפּראַך	װ אַ ס ע ר ש פּ ר אַ כ
װאַסערפֿאַל	װ אַ ס ע ר פֿ אַ ל
װאַקס	װ אַ ק ס
װאַקסט	װ אַ ק ס ט
װאַקסן	װ אַ ק ס נ
װאַקאַציע	װ אַ ק אַ צ י ע
װאַרט	װ אַ ר ט
װאַרטן	װ אַ ר ט נ
װאַרטנדיק	װ אַ ר ט נ ד י ק
װאַרע	װ אַ ר ע
װאַרעם	װ אַ ר ע מ
װאַרעמט	װ אַ ר ע מ ט
װאַרעמס	װ אַ ר ע מ ס
װאַרעמע	װ אַ ר ע מ ע
װאַרעמען	װ אַ ר ע מ ע נ
װאַרעמעס	װ אַ ר ע מ ע ס
װאַרעמער	װ אַ ר ע מ ע ר
װאַרעמקײט	װ אַ ר ע מ ק ײ ט
װאַרף	װ אַ ר פֿ
װאַרשע	װ אַ ר ש ע
װאַרפֿט	װ אַ ר פֿ ט
װאַרפֿן	װ אַ ר פֿ נ
װאַש	װ אַ ש
װאַשט	װ אַ ש ט
װאַשטע	װ אַ ש ט ע
װאַשטען	װ אַ ש ט ע נ
װאַשן	װ אַ ש נ
װאָ־	װ אָ
װאָג	װ אָ ג
װאָגן	װ אָ ג נ
װאָייִסראָן	װ אָ י יִ ס ר אָ נ
װאָך	װ אָ כ
װאָכן	װ אָ כ נ
װאָכנטאָג	װ אָ כ נ ט אָ ג
װאָכעדיקן	װ אָ כ ע ד י ק נ
װאָכעדיקע	װ אָ כ ע ד י ק ע
װאָכעדיקער	װ אָ כ ע ד י ק ע ר
װאָלט	װ אָ ל ט
װאָלטן	װ אָ ל ט נ
װאָלטסט	װ אָ ל ט ס ט
װאָלטסטו	װ אָ ל ט ס ט ו
װאָלף	װ אָ ל פֿ
װאָלקן	װ אָ ל ק נ
װאָלקנדלעך	װ אָ ל ק נ ד ל ע כ
װאָלקנס	װ אָ ל ק נ ס
װאָלװל	װ אָ ל װ ל
װאָלאַך	װ אָ ל אַ כ
װאָלפֿל	װ אָ ל פֿ ל
װאָלפֿן	װ אָ ל פֿ נ
װאָנצעס	װ אָ נ צ ע ס
װאָס	װ אָ ס
װאָס־זשע	װ אָ ס ז ש ע
װאָסער	װ אָ ס ע ר
װאָסערע	װ אָ ס ע ר ע
װאָר	װ אָ ר
װאָרט	װ אָ ר ט
װאָרעם	װ אָ ר ע מ
װאָרף	װ אָ ר פֿ
װאָרצל	װ אָ ר צ ל
װאָרצלען	װ אָ ר צ ל ע נ
װאָרצעלעך	װ אָ ר צ ע ל ע כ
װוּ	װ וּ
װוּ־נישט־װוּ	װ וּ נ י ש ט װ וּ
װוּהין	װ וּ ה י נ
װוּנד	װ וּ נ ד
װוּנדער	װ וּ נ ד ע ר
װוּנדערבאַרן	װ וּ נ ד ע ר ב אַ ר נ
װוּנדערט	װ וּ נ ד ע ר ט
װוּנדערן	װ וּ נ ד ע ר נ
װוּנק	װ וּ נ ק
װוּקס	װ וּ ק ס
ײיצער־האָרע	ײ י צ ע ר ה אָ ר ע
אַ	אַ
אַבי	אַ ב י
אַבײ	אַ ב ײ
אַגמעס־נעפֿעש	אַ ג מ ע ס נ ע פֿ ע ש
אַגרעסן	אַ ג ר ע ס נ
אַגאַװ	אַ ג אַ װ
אַד־הײַעם	אַ ד ה ײַ ע מ
אַדיע	אַ ד י ע
אַדיר	אַ ד י ר
אַדער	אַ ד ע ר
אַדעראַבע	אַ ד ע ר אַ ב ע
אַדרעס	אַ ד ר ע ס
אַדװאָקאַט	אַ ד װ אָ ק אַ ט
אַהין	אַ ה י נ
אַהינגעקומען	אַ ה י נ ג ע ק ו מ ע נ
אַהינטער	אַ ה י נ ט ע ר
אַהינצוטון	אַ ה י נ צ ו ט ו נ
אַהער	אַ ה ע ר
אַהערברענגען	אַ ה ע ר ב ר ע נ ג ע נ
אַהײם	אַ ה ײ מ
אַהײמאײַלן	אַ ה ײ מ ײַ ל נ
אַהײמצוגײן	אַ ה ײ מ צ ו ג ײ נ
אַהאַ	אַ ה אַ
אַהאָ	אַ ה אָ
אַז	אַ ז
אַזעלכן	אַ ז ע ל כ נ
אַזעלכס	אַ ז ע ל כ ס
אַזעלכע	אַ ז ע ל כ ע
אַזעלכעס	אַ ז ע ל כ ע ס
אַזעלכער	אַ ז ע ל כ ע ר
אַזעסדיק	אַ ז ע ס ד י ק
אַזעסקײט	אַ ז ע ס ק ײ ט
אַזש	אַ ז ש
אַזױ	אַ ז ױ
אַזױנס	אַ ז ױ נ ס
אַזױנע	אַ ז ױ נ ע
אַזאַ	אַ ז אַ
אַטלעסענע	אַ ט ל ע ס ע נ ע
אַטלעסענעם	אַ ט ל ע ס ע נ ע מ
אַטלעסענער	אַ ט ל ע ס ע נ ע ר
אַטאָ	אַ ט אָ
אַטאָ־האָרײסאָלע	אַ ט אָ ה אָ ר ײ ס אָ ל ע
אַטאָרע	אַ ט אָ ר ע
אַטאָרעס	אַ ט אָ ר ע ס
אַיעדער	אַ י ע ד ע ר
אַיאָ	אַ י אָ
אַך	אַ כ
אַכדעס	אַ כ ד ע ס
אַכוץ	אַ כ ו צ
אַכט	אַ כ ט
אַכט־און־דרײַסיק	אַ כ ט ו נ ד ר ײַ ס י ק
אַכטונג	אַ כ ט ו נ ג
אַכילע	אַ כ י ל ע
אַכסאַניע	אַ כ ס אַ נ י ע
אַכציק	אַ כ צ י ק
אַכצן	אַ כ צ נ
אַכײנו־בנײ־ייִסראָעל	אַ כ ײ נ ו ב נ ײ י יִ ס ר אָ ע ל
אַל	אַ ל
אַל־	אַ ל
אַלגעבריניק	אַ ל ג ע ב ר י נ י ק
אַלגעברע	אַ ל ג ע ב ר ע
אַלט	אַ ל ט
אַלט־באַקאַנטן	אַ ל ט ב אַ ק אַ נ ט נ
אַלט־גרױער	אַ ל ט ג ר ױ ע ר
אַלטמאָדישן	אַ ל ט מ אָ ד י ש נ
אַלטן	אַ ל ט נ
אַלטע	אַ ל ט ע
אַלטער	אַ ל ט ע ר
אַלטערטום־פֿאָרשער	אַ ל ט ע ר ט ו מ פֿ אָ ר ש ע ר
אַלמאָנע	אַ ל מ אָ נ ע
אַלס	אַ ל ס
אַלע	אַ ל ע
אַלעם	אַ ל ע מ
אַלעמען	אַ ל ע מ ע נ
אַלעמענס	אַ ל ע מ ע נ ס
אַלעס	אַ ל ע ס
אַלעף	אַ ל ע פֿ
אַלערלײ	אַ ל ע ר ל ײ
אַלעװײַ	אַ ל ע װ ײַ
אַלעפֿבײס	אַ ל ע פֿ ב ײ ס
אַלץ	אַ ל צ
אַלצדינג	אַ ל צ ד י נ ג
אַלקער	אַ ל ק ע ר
אַלקײן	אַ ל ק ײ נ
אַלקאָלפּאָנעם	אַ ל ק אָ ל פּ אָ נ ע מ
אַלײכעם־שאָלעם	אַ ל ײ כ ע מ ש אָ ל ע מ
אַלײן	אַ ל ײ נ
אַלײען	אַ ל ײ ע נ
אַלאַבאַסטער	אַ ל אַ ב אַ ס ט ע ר
אַלפּי	אַ ל פּ י
אַם	אַ מ
אַמבאַסאַדאָר	אַ מ ב אַ ס אַ ד אָ ר
אַמער	אַ מ ע ר
אַמעריקע	אַ מ ע ר י ק ע
אַמעריקאַניזירט	אַ מ ע ר י ק אַ נ י ז י ר ט
אַמעריקאַניזירן	אַ מ ע ר י ק אַ נ י ז י ר נ
אַמעריקאַניזם	אַ מ ע ר י ק אַ נ י ז מ
אַמעריקאַנער	אַ מ ע ר י ק אַ נ ע ר
אַמאָליקע	אַ מ אָ ל י ק ע
אַן	אַ נ
אַנדער	אַ נ ד ע ר
אַנדערן	אַ נ ד ע ר נ
אַנדערע	אַ נ ד ע ר ע
אַנדערער	אַ נ ד ע ר ע ר
אַנדערש	אַ נ ד ע ר ש
אַנו	אַ נ ו
אַנומלט	אַ נ ו מ ל ט
אַנומלטן	אַ נ ו מ ל ט נ
אַנטגאַנגען	אַ נ ט ג אַ נ ג ע נ
אַנטיסעמיט	אַ נ ט י ס ע מ י ט
אַנטיק	אַ נ ט י ק
אַנטיק־מאָרע	אַ נ ט י ק מ אָ ר ע
אַנטיקלעך	אַ נ ט י ק ל ע כ
אַנטיקן	אַ נ ט י ק נ
אַנטלױף	אַ נ ט ל ױ פֿ
אַנטלױפֿט	אַ נ ט ל ױ פֿ ט
אַנטלױפֿן	אַ נ ט ל ױ פֿ נ
אַנטלאָפֿן	אַ נ ט ל אָ פֿ נ
אַנטעק	אַ נ ט ע ק
אַנטעקן	אַ נ ט ע ק נ
אַנטקעגן	אַ נ ט ק ע ג נ
אַנטקעגנגעלאָפֿן	אַ נ ט ק ע ג נ ג ע ל אָ פֿ נ
אַנטשולדיקט	אַ נ ט ש ו ל ד י ק ט
אַנטשלאָפֿן	אַ נ ט ש ל אָ פֿ נ
אַני־האַקאָטן	אַ נ י ה אַ ק אָ ט נ
אַנידער	אַ נ י ד ע ר
אַנידערגעלײגט	אַ נ י ד ע ר ג ע ל ײ ג ט
אַנידערגעשטעלט	אַ נ י ד ע ר ג ע ש ט ע ל ט
אַנידערלײגן	אַ נ י ד ע ר ל ײ ג נ
אַניט	אַ נ י ט
אַנשטאָט	אַ נ ש ט אָ ט
אַנאַנד	אַ נ אַ נ ד
אַצינד	אַ צ י נ ד
אַקוראַט	אַ ק ו ר אַ ט
אַקושאָר	אַ ק ו ש אָ ר
אַקט	אַ ק ט
אַקטיאָר	אַ ק ט י אָ ר
אַקטיאָרן	אַ ק ט י אָ ר נ
אַקטן	אַ ק ט נ
אַקסל	אַ ק ס ל
אַקסלען	אַ ק ס ל ע נ
אַקסן	אַ ק ס נ
אַקעגן	אַ ק ע ג נ
אַקציע	אַ ק צ י ע
אַקצענט	אַ ק צ ע נ ט
אַקשן	אַ ק ש נ
אַקאָרעס	אַ ק אָ ר ע ס
אַרבוז	אַ ר ב ו ז
אַרבוזעס	אַ ר ב ו ז ע ס
אַרבל	אַ ר ב ל
אַרבעט	אַ ר ב ע ט
אַרבעטן	אַ ר ב ע ט נ
אַרבעטער	אַ ר ב ע ט ע ר
אַרבעס	אַ ר ב ע ס
אַרבעקאַנפֿעסל	אַ ר ב ע ק אַ נ פֿ ע ס ל
אַרום	אַ ר ו מ
אַרומגעגאַרטלט	אַ ר ו מ ג ע ג אַ ר ט ל ט
אַרומגעטאַנצט	אַ ר ו מ ג ע ט אַ נ צ ט
אַרומגעכאַפּט	אַ ר ו מ ג ע כ אַ פּ ט
אַרומגענומען	אַ ר ו מ ג ע נ ו מ ע נ
אַרומגעצױמט	אַ ר ו מ ג ע צ ױ מ ט
אַרומגעצאָלט	אַ ר ו מ ג ע צ אָ ל ט
אַרומגעקוקט	אַ ר ו מ ג ע ק ו ק ט
אַרומגעשטעלט	אַ ר ו מ ג ע ש ט ע ל ט
אַרומגעשטעקט	אַ ר ו מ ג ע ש ט ע ק ט
אַרומגעשפּרונגען	אַ ר ו מ ג ע ש פּ ר ו נ ג ע נ
אַרומגײן	אַ ר ו מ ג ײ נ
אַרומיקע	אַ ר ו מ י ק ע
אַרומקוקן	אַ ר ו מ ק ו ק נ
אַרומװאַלגערן	אַ ר ו מ װ אַ ל ג ע ר נ
אַרונטער	אַ ר ו נ ט ע ר
אַרונטערגעגאַנגען	אַ ר ו נ ט ע ר ג ע ג אַ נ ג ע נ
אַרונטערגעלײגט	אַ ר ו נ ט ע ר ג ע ל ײ ג ט
אַרונטערגענומען	אַ ר ו נ ט ע ר ג ע נ ו מ ע נ
אַרונטערגערוקט	אַ ר ו נ ט ע ר ג ע ר ו ק ט
אַרט	אַ ר ט
אַרטיסט	אַ ר ט י ס ט
אַרטיסטן	אַ ר ט י ס ט נ
אַרטיקל	אַ ר ט י ק ל
אַריבער	אַ ר י ב ע ר
אַריבערגעגאַנװעט	אַ ר י ב ע ר ג ע ג אַ נ װ ע ט
אַריבערגעשפּאַנט	אַ ר י ב ע ר ג ע ש פּ אַ נ ט
אַריבערגעװוּנקען	אַ ר י ב ע ר ג ע װ וּ נ ק ע נ
אַריבערטראָגן	אַ ר י ב ע ר ט ר אָ ג נ
אַריבערפֿירן	אַ ר י ב ע ר פֿ י ר נ
אַריסטאָקראַטיש	אַ ר י ס ט אָ ק ר אַ ט י ש
אַריסטאָקראַטישער	אַ ר י ס ט אָ ק ר אַ ט י ש ע ר
אַרן	אַ ר נ
אַרן־ליב	אַ ר נ ל י ב
אַרן־ליבס	אַ ר נ ל י ב ס
אַרן־לײב	אַ ר נ ל ײ ב
אַרעסט	אַ ר ע ס ט
אַרױס	אַ ר ױ ס
אַרױסבאַקומען	אַ ר ױ ס ב אַ ק ו מ ע נ
אַרױסבאַװיזן	אַ ר ױ ס ב אַ װ י ז נ
אַרױסבאַװײַזן	אַ ר ױ ס ב אַ װ ײַ ז נ
אַרױסגעבן	אַ ר ױ ס ג ע ב נ
אַרױסגעגאַנגען	אַ ר ױ ס ג ע ג אַ נ ג ע נ
אַרױסגעגאַנװעט	אַ ר ױ ס ג ע ג אַ נ װ ע ט
אַרױסגעגאָסן	אַ ר ױ ס ג ע ג אָ ס נ
אַרױסגעדרינגט	אַ ר ױ ס ג ע ד ר י נ ג ט
אַרױסגעדרענגט	אַ ר ױ ס ג ע ד ר ע נ ג ט
אַרױסגעטריבן	אַ ר ױ ס ג ע ט ר י ב נ
אַרױסגעכאַפּט	אַ ר ױ ס ג ע כ אַ פּ ט
אַרױסגעלאַטכנט	אַ ר ױ ס ג ע ל אַ ט כ נ ט
אַרױסגעלאָזט	אַ ר ױ ס ג ע ל אָ ז ט
אַרױסגעלאָפֿן	אַ ר ױ ס ג ע ל אָ פֿ נ
אַרױסגעמעשאַלײעכט	אַ ר ױ ס ג ע מ ע ש אַ ל ײ ע כ ט
אַרױסגענומען	אַ ר ױ ס ג ע נ ו מ ע נ
אַרױסגעצױגן	אַ ר ױ ס ג ע צ ױ ג נ
אַרױסגעקוקט	אַ ר ױ ס ג ע ק ו ק ט
אַרױסגעקושט	אַ ר ױ ס ג ע ק ו ש ט
אַרױסגעקריגן	אַ ר ױ ס ג ע ק ר י ג נ
אַרױסגעקראָכן	אַ ר ױ ס ג ע ק ר אָ כ נ
אַרױסגעקײַכט	אַ ר ױ ס ג ע ק ײַ כ ט
אַרױסגעריסן	אַ ר ױ ס ג ע ר י ס נ
אַרױסגעראַטעװעט	אַ ר ױ ס ג ע ר אַ ט ע װ ע ט
אַרױסגעשטופּט	אַ ר ױ ס ג ע ש ט ו פּ ט
אַרױסגעשטעלט	אַ ר ױ ס ג ע ש ט ע ל ט
אַרױסגעשטאַרט	אַ ר ױ ס ג ע ש ט אַ ר ט
אַרױסגעשײַנט	אַ ר ױ ס ג ע ש ײַ נ ט
אַרױסגעשפּראָצט	אַ ר ױ ס ג ע ש פּ ר אָ צ ט
אַרױסגעװיזן	אַ ר ױ ס ג ע װ י ז נ
אַרױסגעװאָרפֿן	אַ ר ױ ס ג ע װ אָ ר פֿ נ
אַרױסגעפֿאַלן	אַ ר ױ ס ג ע פֿ אַ ל נ
אַרױסגײענדיק	אַ ר ױ ס ג ײ ע נ ד י ק
אַרױסגײער	אַ ר ױ ס ג ײ ע ר
אַרױסזאָגן	אַ ר ױ ס ז אָ ג נ
אַרױסטרײַבן	אַ ר ױ ס ט ר ײַ ב נ
אַרױסטראָגן	אַ ר ױ ס ט ר אָ ג נ
אַרױסלױפֿנדיק	אַ ר ױ ס ל ױ פֿ נ ד י ק
אַרױסלאָזן	אַ ר ױ ס ל אָ ז נ
אַרױסנעמען	אַ ר ױ ס נ ע מ ע נ
אַרױסצולאָזן	אַ ר ױ ס צ ו ל אָ ז נ
אַרױסצונעמען	אַ ר ױ ס צ ו נ ע מ ע נ
אַרױסצורעדן	אַ ר ױ ס צ ו ר ע ד נ
אַרױסצוּװאַרפֿן	אַ ר ױ ס צ וּ װ אַ ר פֿ נ
אַרױסקומען	אַ ר ױ ס ק ו מ ע נ
אַרױסקומענדיק	אַ ר ױ ס ק ו מ ע נ ד י ק
אַרױסקרײען	אַ ר ױ ס ק ר ײ ע נ
אַרױסרײַסן	אַ ר ױ ס ר ײַ ס נ
אַרױסשטעקנדיק	אַ ר ױ ס ש ט ע ק נ ד י ק
אַרױסװײַזן	אַ ר ױ ס װ ײַ ז נ
אַרױסװאַרפֿן	אַ ר ױ ס װ אַ ר פֿ נ
אַרױף	אַ ר ױ פֿ
אַרױף־אַרױף	אַ ר ױ פֿ אַ ר ױ פֿ
אַרױפֿגעבראַכט	אַ ר ױ פֿ ג ע ב ר אַ כ ט
אַרױפֿגעכאַפּט	אַ ר ױ פֿ ג ע כ אַ פּ ט
אַרױפֿגעלײגט	אַ ר ױ פֿ ג ע ל ײ ג ט
אַרױפֿלײגן	אַ ר ױ פֿ ל ײ ג נ
אַרױפֿרוקנדיק	אַ ר ױ פֿ ר ו ק נ ד י ק
אַרײלעס	אַ ר ײ ל ע ס
אַרײװים	אַ ר ײ װ י מ
אַרײַ־	אַ ר ײַ
אַרײַן	אַ ר ײַ נ
אַרײַנברענגען	אַ ר ײַ נ ב ר ע נ ג ע נ
אַרײַנגעבראַכט	אַ ר ײַ נ ג ע ב ר אַ כ ט
אַרײַנגעבראָקט	אַ ר ײַ נ ג ע ב ר אָ ק ט
אַרײַנגעגעבן	אַ ר ײַ נ ג ע ג ע ב נ
אַרײַנגעגאָסן	אַ ר ײַ נ ג ע ג אָ ס נ
אַרײַנגעדרענגט	אַ ר ײַ נ ג ע ד ר ע נ ג ט
אַרײַנגעדרײט	אַ ר ײַ נ ג ע ד ר ײ ט
אַרײַנגעזעצטע	אַ ר ײַ נ ג ע ז ע צ ט ע
אַרײַנגעטראָגן	אַ ר ײַ נ ג ע ט ר אָ ג נ
אַרײַנגעטײלט	אַ ר ײַ נ ג ע ט ײ ל ט
אַרײַנגעכאַפּט	אַ ר ײַ נ ג ע כ אַ פּ ט
אַרײַנגעלײגט	אַ ר ײַ נ ג ע ל ײ ג ט
אַרײַנגעלאָזט	אַ ר ײַ נ ג ע ל אָ ז ט
אַרײַנגעמישט	אַ ר ײַ נ ג ע מ י ש ט
אַרײַנגענומען	אַ ר ײַ נ ג ע נ ו מ ע נ
אַרײַנגעצױגן	אַ ר ײַ נ ג ע צ ױ ג נ
אַרײַנגעקומען	אַ ר ײַ נ ג ע ק ו מ ע נ
אַרײַנגעקוקט	אַ ר ײַ נ ג ע ק ו ק ט
אַרײַנגעקלאַפּט	אַ ר ײַ נ ג ע ק ל אַ פּ ט
אַרײַנגעקאַטשעט	אַ ר ײַ נ ג ע ק אַ ט ש ע ט
אַרײַנגערוקט	אַ ר ײַ נ ג ע ר ו ק ט
אַרײַנגערופֿן	אַ ר ײַ נ ג ע ר ו פֿ נ
אַרײַנגעשטעלט	אַ ר ײַ נ ג ע ש ט ע ל ט
אַרײַנגעשטעקט	אַ ר ײַ נ ג ע ש ט ע ק ט
אַרײַנגעשטרײַכטע	אַ ר ײַ נ ג ע ש ט ר ײַ כ ט ע
אַרײַנגעשריגן	אַ ר ײַ נ ג ע ש ר י ג נ
אַרײַנגעשװוּמען	אַ ר ײַ נ ג ע ש װ וּ מ ע נ
אַרײַנגעפּליאָסקעט	אַ ר ײַ נ ג ע פּ ל י אָ ס ק ע ט
אַרײַנגעפּלאָנטעט	אַ ר ײַ נ ג ע פּ ל אָ נ ט ע ט
אַרײַנגעפֿירט	אַ ר ײַ נ ג ע פֿ י ר ט
אַרײַנגעפֿלאָסן	אַ ר ײַ נ ג ע פֿ ל אָ ס נ
אַרײַנגעפֿאַלן	אַ ר ײַ נ ג ע פֿ אַ ל נ
אַרײַנגעפֿאַסטע	אַ ר ײַ נ ג ע פֿ אַ ס ט ע
אַרײַנגײענדיק	אַ ר ײַ נ ג ײ ע נ ד י ק
אַרײַנדרײען	אַ ר ײַ נ ד ר ײ ע נ
אַרײַנזעצן	אַ ר ײַ נ ז ע צ נ
אַרײַנטרעטן	אַ ר ײַ נ ט ר ע ט נ
אַרײַנטראָגן	אַ ר ײַ נ ט ר אָ ג נ
אַרײַנכאַפּן	אַ ר ײַ נ כ אַ פּ נ
אַרײַנלײגן	אַ ר ײַ נ ל ײ ג נ
אַרײַנלײגנדיק	אַ ר ײַ נ ל ײ ג נ ד י ק
אַרײַנצוגאַנװענען	אַ ר ײַ נ צ ו ג אַ נ װ ע נ ע נ
אַרײַנצונעמען	אַ ר ײַ נ צ ו נ ע מ ע נ
אַרײַנצוקומען	אַ ר ײַ נ צ ו ק ו מ ע נ
אַרײַנצוקוקן	אַ ר ײַ נ צ ו ק ו ק נ
אַרײַנקומען	אַ ר ײַ נ ק ו מ ע נ
אַרײַנקוקן	אַ ר ײַ נ ק ו ק נ
אַרײַנרוקן	אַ ר ײַ נ ר ו ק נ
אַרײַנרעכענען	אַ ר ײַ נ ר ע כ ע נ ע נ
אַרײַנשטעקן	אַ ר ײַ נ ש ט ע ק נ
אַרײַנװאַרפֿן	אַ ר ײַ נ װ אַ ר פֿ נ
אַראָפּ	אַ ר אָ פּ
אַראָפּברענגען	אַ ר אָ פּ ב ר ע נ ג ע נ
אַראָפּגעבראַכט	אַ ר אָ פּ ג ע ב ר אַ כ ט
אַראָפּגעבױגן	אַ ר אָ פּ ג ע ב ױ ג נ
אַראָפּגעגאָסן	אַ ר אָ פּ ג ע ג אָ ס נ
אַראָפּגעהאָנגען	אַ ר אָ פּ ג ע ה אָ נ ג ע נ
אַראָפּגעלױכטן	אַ ר אָ פּ ג ע ל ױ כ ט נ
אַראָפּגעלאָזט	אַ ר אָ פּ ג ע ל אָ ז ט
אַראָפּגעלאָזטן	אַ ר אָ פּ ג ע ל אָ ז ט נ
אַראָפּגעלאָזטע	אַ ר אָ פּ ג ע ל אָ ז ט ע
אַראָפּגעלאָזענעם	אַ ר אָ פּ ג ע ל אָ ז ע נ ע מ
אַראָפּגענומען	אַ ר אָ פּ ג ע נ ו מ ע נ
אַראָפּגעקוקט	אַ ר אָ פּ ג ע ק ו ק ט
אַראָפּגעריסן	אַ ר אָ פּ ג ע ר י ס נ
אַראָפּגעשלײַדערט	אַ ר אָ פּ ג ע ש ל ײַ ד ע ר ט
אַראָפּגעװאָרפֿן	אַ ר אָ פּ ג ע װ אָ ר פֿ נ
אַראָפּגעפּאַטערט	אַ ר אָ פּ ג ע פּ אַ ט ע ר ט
אַראָפּגעפֿונקלט	אַ ר אָ פּ ג ע פֿ ו נ ק ל ט
אַראָפּגעפֿאַלן	אַ ר אָ פּ ג ע פֿ אַ ל נ
אַראָפּגײן	אַ ר אָ פּ ג ײ נ
אַראָפּװאַרפֿן	אַ ר אָ פּ װ אַ ר פֿ נ
אַראָפּפֿאַלן	אַ ר אָ פּ פֿ אַ ל נ
אַראָפּפֿאָרן	אַ ר אָ פּ פֿ אָ ר נ
אַש	אַ ש
אַשקענאַזים	אַ ש ק ע נ אַ ז י מ
אַשרײ	אַ ש ר ײ
אַװ־בעזדן	אַ װ ב ע ז ד נ
אַװי־יעסױמים	אַ װ י י ע ס ױ מ י מ
אַװלע	אַ װ ל ע
אַװעק	אַ װ ע ק
אַװעקגעבן	אַ װ ע ק ג ע ב נ
אַװעקגעגעבן	אַ װ ע ק ג ע ג ע ב נ
אַװעקגעגאַנגען	אַ װ ע ק ג ע ג אַ נ ג ע נ
אַװעקגעזעצט	אַ װ ע ק ג ע ז ע צ ט
אַװעקגעלײגט	אַ װ ע ק ג ע ל ײ ג ט
אַװעקגעלאָפֿן	אַ װ ע ק ג ע ל אָ פֿ נ
אַװעקגענומען	אַ װ ע ק ג ע נ ו מ ע נ
אַװעקגעקױפֿט	אַ װ ע ק ג ע ק ױ פֿ ט
אַװעקגערוקט	אַ װ ע ק ג ע ר ו ק ט
אַװעקגערופֿן	אַ װ ע ק ג ע ר ו פֿ נ
אַװעקגעשטופּט	אַ װ ע ק ג ע ש ט ו פּ ט
אַװעקגעשטעלט	אַ װ ע ק ג ע ש ט ע ל ט
אַװעקגעשיקט	אַ װ ע ק ג ע ש י ק ט
אַװעקגעשװוּמען	אַ װ ע ק ג ע ש װ וּ מ ע נ
אַװעקגעשפּרונגען	אַ װ ע ק ג ע ש פּ ר ו נ ג ע נ
אַװעקגעװאָרפֿן	אַ װ ע ק ג ע װ אָ ר פֿ נ
אַװעקגעפֿלױגן	אַ װ ע ק ג ע פֿ ל ױ ג נ
אַװעקגעפֿאָרן	אַ װ ע ק ג ע פֿ אָ ר נ
אַװעקזעצן	אַ װ ע ק ז ע צ נ
אַװעקטראָגן	אַ װ ע ק ט ר אָ ג נ
אַװעקמאַכן	אַ װ ע ק מ אַ כ נ
אַװעקנעמען	אַ װ ע ק נ ע מ ע נ
אַװעקנעמענדיק	אַ װ ע ק נ ע מ ע נ ד י ק
אַװעקצולײגן	אַ װ ע ק צ ו ל ײ ג נ
אַװעקצוקױלען	אַ װ ע ק צ ו ק ױ ל ע נ
אַװעקשטעלן	אַ װ ע ק ש ט ע ל נ
אַװעקשלײַדערן	אַ װ ע ק ש ל ײַ ד ע ר נ
אַװראָהאָם	אַ װ ר אָ ה אָ מ
אַװראָם	אַ װ ר אָ מ
אַװראָם־אָבֿינו־סאַנדעקאָעס	אַ װ ר אָ מ אָ בֿ י נ ו ס אַ נ ד ע ק אָ ע ס
אַװײרע	אַ װ ײ ר ע
אַװאַדע	אַ װ אַ ד ע
אַװאַנטי	אַ װ אַ נ ט י
אַאַ	אַ אַ
אַאַאַ	אַ אַ אַ
אַפּטײק	אַ פּ ט ײ ק
אַפּיקױרעס	אַ פּ י ק ױ ר ע ס
אַפּיקאָרסים	אַ פּ י ק אָ ר ס י מ
אַפּלױז	אַ פּ ל ױ ז
אַפּלאָדיסמענטן	אַ פּ ל אָ ד י ס מ ע נ ט נ
אַפּלאָדירן	אַ פּ ל אָ ד י ר נ
אַפּױטיקע	אַ פּ ױ ט י ק ע
אַפֿילע	אַ פֿ י ל ע
אָ	אָ
אָ־אָ	אָ אָ
אָבער	אָ ב ע ר
אָדלער	אָ ד ל ע ר
אָדעם	אָ ד ע מ
אָדער	אָ ד ע ר
אָהאָ	אָ ה אָ
אָזשעניצעס	אָ ז ש ע נ י צ ע ס
אָט	אָ ט
אָטעם	אָ ט ע מ
אָטשערעד	אָ ט ש ע ר ע ד
אָטשערעדן	אָ ט ש ע ר ע ד נ
אָך	אָ כ
אָכי	אָ כ י
אָל	אָ ל
אָלעהאַשאָלעם	אָ ל ע ה אַ ש אָ ל ע מ
אָלעװאַשאָלעם	אָ ל ע װ אַ ש אָ ל ע מ
אָלײנו	אָ ל ײ נ ו
אָמעד	אָ מ ע ד
אָמײן	אָ מ ײ נ
אָמאַר	אָ מ אַ ר
אָן	אָ נ
אָנבױגן	אָ נ ב ױ ג נ
אָנבײַסן	אָ נ ב ײַ ס נ
אָנבאַלאַנגט	אָ נ ב אַ ל אַ נ ג ט
אָנבאָטן	אָ נ ב אָ ט נ
אָנגיסן	אָ נ ג י ס נ
אָנגעבוכעט	אָ נ ג ע ב ו כ ע ט
אָנגעבונדן	אָ נ ג ע ב ו נ ד נ
אָנגעבלאָזן	אָ נ ג ע ב ל אָ ז נ
אָנגעבױגן	אָ נ ג ע ב ױ ג נ
אָנגעגעסן	אָ נ ג ע ג ע ס נ
אָנגעגאַנגען	אָ נ ג ע ג אַ נ ג ע נ
אָנגעגאַרטלט	אָ נ ג ע ג אַ ר ט ל ט
אָנגעגאָסן	אָ נ ג ע ג אָ ס נ
אָנגעהױבן	אָ נ ג ע ה ױ ב נ
אָנגעהאָרעװעטע	אָ נ ג ע ה אָ ר ע װ ע ט ע
אָנגעזעצט	אָ נ ג ע ז ע צ ט
אָנגעזױגן	אָ נ ג ע ז ױ ג נ
אָנגעזױפֿן	אָ נ ג ע ז ױ פֿ נ
אָנגעזאָגט	אָ נ ג ע ז אָ ג ט
אָנגעטון	אָ נ ג ע ט ו נ
אָנגעטרונקען	אָ נ ג ע ט ר ו נ ק ע נ
אָנגעטראָפֿן	אָ נ ג ע ט ר אָ פֿ נ
אָנגעטאָן	אָ נ ג ע ט אָ נ
אָנגעכאַפּט	אָ נ ג ע כ אַ פּ ט
אָנגעלענט	אָ נ ג ע ל ע נ ט
אָנגעלײגט	אָ נ ג ע ל ײ ג ט
אָנגעמוטשעט	אָ נ ג ע מ ו ט ש ע ט
אָנגעמאַכט	אָ נ ג ע מ אַ כ ט
אָנגעמאָסטן	אָ נ ג ע מ אָ ס ט נ
אָנגענומען	אָ נ ג ע נ ו מ ע נ
אָנגעצונדן	אָ נ ג ע צ ו נ ד נ
אָנגעצױגן	אָ נ ג ע צ ױ ג נ
אָנגעקומען	אָ נ ג ע ק ו מ ע נ
אָנגעקומענע	אָ נ ג ע ק ו מ ע נ ע
אָנגעקליבן	אָ נ ג ע ק ל י ב נ
אָנגעקלעפּט	אָ נ ג ע ק ל ע פּ ט
אָנגעקלאַפּט	אָ נ ג ע ק ל אַ פּ ט
אָנגעקאָרמעט	אָ נ ג ע ק אָ ר מ ע ט
אָנגערוקט	אָ נ ג ע ר ו ק ט
אָנגערופֿן	אָ נ ג ע ר ו פֿ נ
אָנגערעכנט	אָ נ ג ע ר ע כ נ ט
אָנגעשטעלט	אָ נ ג ע ש ט ע ל ט
אָנגעשלאָגן	אָ נ ג ע ש ל אָ ג נ
אָנגעשריבן	אָ נ ג ע ש ר י ב נ
אָנגעשריבענע	אָ נ ג ע ש ר י ב ע נ ע
אָנגעשריבענעם	אָ נ ג ע ש ר י ב ע נ ע מ
אָנגעשװאָלענע	אָ נ ג ע ש װ אָ ל ע נ ע
אָנגעשאָטן	אָ נ ג ע ש אָ ט נ
אָנגעװיזן	אָ נ ג ע װ י ז נ
אָנגעװױרן	אָ נ ג ע װ ױ ר נ
אָנגעפֿילט	אָ נ ג ע פֿ י ל ט
אָנגעפֿילטער	אָ נ ג ע פֿ י ל ט ע ר
אָנגעפֿרעסן	אָ נ ג ע פֿ ר ע ס נ
אָנגעפֿאַלן	אָ נ ג ע פֿ אַ ל נ
אָנגײן	אָ נ ג ײ נ
אָנדערטהאַלבן	אָ נ ד ע ר ט ה אַ ל ב נ
אָנהענגען	אָ נ ה ע נ ג ע נ
אָנהױב	אָ נ ה ױ ב
אָנהױבן	אָ נ ה ױ ב נ
אָנהײב	אָ נ ה ײ ב
אָנזען	אָ נ ז ע נ
אָנזעענדיקן	אָ נ ז ע ע נ ד י ק נ
אָנזאָגן	אָ נ ז אָ ג נ
אָנטראָגן	אָ נ ט ר אָ ג נ
אָנטאָן	אָ נ ט אָ נ
אָניצעס	אָ נ י צ ע ס
אָנלענען	אָ נ ל ע נ ע נ
אָנלענער	אָ נ ל ע נ ע ר
אָנלײגן	אָ נ ל ײ ג נ
אָננעמען	אָ נ נ ע מ ע נ
אָננעמענדיק	אָ נ נ ע מ ע נ ד י ק
אָנעװ	אָ נ ע װ
אָנצוזאָגן	אָ נ צ ו ז אָ ג נ
אָנצולױפֿן	אָ נ צ ו ל ױ פֿ נ
אָנצוצינדן	אָ נ צ ו צ י נ ד נ
אָנצוקוקן	אָ נ צ ו ק ו ק נ
אָנצינדן	אָ נ צ י נ ד נ
אָנצײנערדיקן	אָ נ צ ײ נ ע ר ד י ק נ
אָנציִען	אָ נ צ יִ ע נ
אָנקומען	אָ נ ק ו מ ע נ
אָנקומענדיק	אָ נ ק ו מ ע נ ד י ק
אָנקומעניש	אָ נ ק ו מ ע נ י ש
אָנקוקן	אָ נ ק ו ק נ
אָנקוקנדיק	אָ נ ק ו ק נ ד י ק
אָנרופֿן	אָ נ ר ו פֿ נ
אָנרירן	אָ נ ר י ר נ
אָנשטופּן	אָ נ ש ט ו פּ נ
אָנשטאָט	אָ נ ש ט אָ ט
אָנשיקעניש	אָ נ ש י ק ע נ י ש
אָנשמעקן	אָ נ ש מ ע ק נ
אָנשרײַבן	אָ נ ש ר ײַ ב נ
אָנשפּיגלען	אָ נ ש פּ י ג ל ע נ
אָנשפּילן	אָ נ ש פּ י ל נ
אָנװינטשעװען	אָ נ װ י נ ט ש ע װ ע נ
אָנװײַזונגען	אָ נ װ ײַ ז ו נ ג ע נ
אָנװײַזן	אָ נ װ ײַ ז נ
אָנװאַרעמען	אָ נ װ אַ ר ע מ ע נ
אָנפֿירער	אָ נ פֿ י ר ע ר
אָס	אָ ס
אָסטרע	אָ ס ט ר ע
אָסער	אָ ס ע ר
אָסער־לעדאַבער	אָ ס ע ר ל ע ד אַ ב ע ר
אָף	אָ פֿ
אָקס	אָ ק ס
אָקסן	אָ ק ס נ
אָקסנשריט	אָ ק ס נ ש ר י ט
אָקעװיט	אָ ק ע װ י ט
אָרגיע	אָ ר ג י ע
אָרדענונג	אָ ר ד ע נ ו נ ג
אָרט	אָ ר ט
אָרכים	אָ ר כ י מ
אָרל	אָ ר ל
אָרנטלעכע	אָ ר נ ט ל ע כ ע
אָרנקױדעש	אָ ר נ ק ױ ד ע ש
אָרעם	אָ ר ע מ
אָרעמס	אָ ר ע מ ס
אָרעמע	אָ ר ע מ ע
אָרעמקײט	אָ ר ע מ ק ײ ט
אָרעמאַן	אָ ר ע מ אַ נ
אָרעװ	אָ ר ע װ
אָװין	אָ װ י נ
אָװינו	אָ װ י נ ו
אָװנט	אָ װ נ ט
אָװאַ	אָ װ אַ
אָפּ	אָ פּ
אָפּבעטן	אָ פּ ב ע ט נ
אָפּבײַטן	אָ פּ ב ײַ ט נ
אָפּבײַסן	אָ פּ ב ײַ ס נ
אָפּגעבליט	אָ פּ ג ע ב ל י ט
אָפּגעבן	אָ פּ ג ע ב נ
אָפּגעבענטשט	אָ פּ ג ע ב ע נ ט ש ט
אָפּגעבריט	אָ פּ ג ע ב ר י ט
אָפּגעברענט	אָ פּ ג ע ב ר ע נ ט
אָפּגעבראַכט	אָ פּ ג ע ב ר אַ כ ט
אָפּגעבאַקן	אָ פּ ג ע ב אַ ק נ
אָפּגעגלאַנצט	אָ פּ ג ע ג ל אַ נ צ ט
אָפּגעגעבן	אָ פּ ג ע ג ע ב נ
אָפּגעגעסן	אָ פּ ג ע ג ע ס נ
אָפּגעגריזשעטע	אָ פּ ג ע ג ר י ז ש ע ט ע
אָפּגעגאַנגען	אָ פּ ג ע ג אַ נ ג ע נ
אָפּגעגאָלט	אָ פּ ג ע ג אָ ל ט
אָפּגעדעקטער	אָ פּ ג ע ד ע ק ט ע ר
אָפּגעהיטן	אָ פּ ג ע ה י ט נ
אָפּגעהאַלטן	אָ פּ ג ע ה אַ ל ט נ
אָפּגעהאַנדלט	אָ פּ ג ע ה אַ נ ד ל ט
אָפּגעהאַקט	אָ פּ ג ע ה אַ ק ט
אָפּגעהאַקטע	אָ פּ ג ע ה אַ ק ט ע
אָפּגעזונדערט	אָ פּ ג ע ז ו נ ד ע ר ט
אָפּגעזיפֿצט	אָ פּ ג ע ז י פֿ צ ט
אָפּגעזאָגט	אָ פּ ג ע ז אָ ג ט
אָפּגעטראָטן	אָ פּ ג ע ט ר אָ ט נ
אָפּגעטײלט	אָ פּ ג ע ט ײ ל ט
אָפּגעטאָן	אָ פּ ג ע ט אָ נ
אָפּגעטאָקטע	אָ פּ ג ע ט אָ ק ט ע
אָפּגעלעבט	אָ פּ ג ע ל ע ב ט
אָפּגעלעבטע	אָ פּ ג ע ל ע ב ט ע
אָפּגעלײגט	אָ פּ ג ע ל ײ ג ט
אָפּגעלײגטע	אָ פּ ג ע ל ײ ג ט ע
אָפּגעלאָזט	אָ פּ ג ע ל אָ ז ט
אָפּגעמאַכט	אָ פּ ג ע מ אַ כ ט
אָפּגעמאָסטן	אָ פּ ג ע מ אָ ס ט נ
אָפּגענאַרט	אָ פּ ג ע נ אַ ר ט
אָפּגעענטפֿערט	אָ פּ ג ע ע נ ט פֿ ע ר ט
אָפּגעצײלטע	אָ פּ ג ע צ ײ ל ט ע
אָפּגעקומען	אָ פּ ג ע ק ו מ ע נ
אָפּגעקומענער	אָ פּ ג ע ק ו מ ע נ ע ר
אָפּגעקלונגען	אָ פּ ג ע ק ל ו נ ג ע נ
אָפּגעקלאַפּט	אָ פּ ג ע ק ל אַ פּ ט
אָפּגעקנאַקט	אָ פּ ג ע ק נ אַ ק ט
אָפּגעקערט	אָ פּ ג ע ק ע ר ט
אָפּגעקערעװעט	אָ פּ ג ע ק ע ר ע װ ע ט
אָפּגעקרעכצט	אָ פּ ג ע ק ר ע כ צ ט
אָפּגעקרײט	אָ פּ ג ע ק ר ײ ט
אָפּגעקױפֿט	אָ פּ ג ע ק ױ פֿ ט
אָפּגעקאָכט	אָ פּ ג ע ק אָ כ ט
אָפּגעקאָסט	אָ פּ ג ע ק אָ ס ט
אָפּגערוקט	אָ פּ ג ע ר ו ק ט
אָפּגעריבענע	אָ פּ ג ע ר י ב ע נ ע
אָפּגעריכט	אָ פּ ג ע ר י כ ט
אָפּגעריסן	אָ פּ ג ע ר י ס נ
אָפּגעריסענע	אָ פּ ג ע ר י ס ע נ ע
אָפּגערעדט	אָ פּ ג ע ר ע ד ט
אָפּגעשטופּט	אָ פּ ג ע ש ט ו פּ ט
אָפּגעשטעלט	אָ פּ ג ע ש ט ע ל ט
אָפּגעשטעקט	אָ פּ ג ע ש ט ע ק ט
אָפּגעשטאַט	אָ פּ ג ע ש ט אַ ט
אָפּגעשליסענע	אָ פּ ג ע ש ל י ס ע נ ע
אָפּגעשלאָגן	אָ פּ ג ע ש ל אָ ג נ
אָפּגעשריבן	אָ פּ ג ע ש ר י ב נ
אָפּגעשאַלט	אָ פּ ג ע ש אַ ל ט
אָפּגעשאָרן	אָ פּ ג ע ש אָ ר נ
אָפּגעשפּילט	אָ פּ ג ע ש פּ י ל ט
אָפּגעװײנען	אָ פּ ג ע װ ײ נ ע נ
אָפּגעװאָרפֿן	אָ פּ ג ע װ אָ ר פֿ נ
אָפּגעפֿרױרן	אָ פּ ג ע פֿ ר ױ ר נ
אָפּגעפֿאַלענע	אָ פּ ג ע פֿ אַ ל ע נ ע
אָפּדרײען	אָ פּ ד ר ײ ע נ
אָפּדאַרן	אָ פּ ד אַ ר נ
אָפּדאַװענען	אָ פּ ד אַ װ ע נ ע נ
אָפּהאַנדלען	אָ פּ ה אַ נ ד ל ע נ
אָפּזאָגן	אָ פּ ז אָ ג נ
אָפּטון	אָ פּ ט ו נ
אָפּטרעטן	אָ פּ ט ר ע ט נ
אָפּטרענען	אָ פּ ט ר ע נ ע נ
אָפּטרײסלען	אָ פּ ט ר ײ ס ל ע נ
אָפּטײלן	אָ פּ ט ײ ל נ
אָפּלעקן	אָ פּ ל ע ק נ
אָפּלױבן	אָ פּ ל ױ ב נ
אָפּלאָזן	אָ פּ ל אָ ז נ
אָפּנעמען	אָ פּ נ ע מ ע נ
אָפּעראַציעס	אָ פּ ע ר אַ צ י ע ס
אָפּצודאַנקען	אָ פּ צ ו ד אַ נ ק ע נ
אָפּצוטרעטן	אָ פּ צ ו ט ר ע ט נ
אָפּצולײגן	אָ פּ צ ו ל ײ ג נ
אָפּצוקאָכן	אָ פּ צ ו ק אָ כ נ
אָפּצושינדן	אָ פּ צ ו ש י נ ד נ
אָפּצושנײַדן	אָ פּ צ ו ש נ ײַ ד נ
אָפּצאַסן	אָ פּ צ אַ ס נ
אָפּצאָלן	אָ פּ צ אָ ל נ
אָפּריכטן	אָ פּ ר י כ ט נ
אָפּרעכענען	אָ פּ ר ע כ ע נ ע נ
אָפּרײניקן	אָ פּ ר ײ נ י ק נ
אָפּרײַסן	אָ פּ ר ײַ ס נ
אָפּשטעלן	אָ פּ ש ט ע ל נ
אָפּשטעקן	אָ פּ ש ט ע ק נ
אָפּשװײַגן	אָ פּ ש װ ײַ ג נ
אָפּשפּילן	אָ פּ ש פּ י ל נ
אָפּװעגן	אָ פּ װ ע ג נ
אָפּװאַרטן	אָ פּ װ אַ ר ט נ
אָפּפֿירגעלט	אָ פּ פֿ י ר ג ע ל ט
אָפּפֿירן	אָ פּ פֿ י ר נ
אָפּפֿאַלן	אָ פּ פֿ אַ ל נ
אָפּפֿאַסטן	אָ פּ פֿ אַ ס ט נ
אָפֿט	אָ פֿ ט
אָפֿן	אָ פֿ נ
אָפֿענע	אָ פֿ ע נ ע
אָפֿענעם	אָ פֿ ע נ ע מ
פּובליקום	פּ ו ב ל י ק ו מ
פּוד	פּ ו ד
פּוטער	פּ ו ט ע ר
פּוטער־בולקעס	פּ ו ט ע ר ב ו ל ק ע ס
פּוטער־געבעקס	פּ ו ט ע ר ג ע ב ע ק ס
פּוטער־געבעקסל	פּ ו ט ע ר ג ע ב ע ק ס ל
פּוטער־געבעקסלעך	פּ ו ט ע ר ג ע ב ע ק ס ל ע כ
פּוטערברױט	פּ ו ט ע ר ב ר ױ ט
פּונקט	פּ ו נ ק ט
פּוסטן	פּ ו ס ט נ
פּוסטע	פּ ו ס ט ע
פּורים	פּ ו ר י מ
פּורים־קױלעטש	פּ ו ר י מ ק ױ ל ע ט ש
פּורים־שפּילער	פּ ו ר י מ ש פּ י ל ע ר
פּורקאָניִיאָ	פּ ו ר ק אָ נ יִ י אָ
פּופּיק	פּ ו פּ י ק
פּי	פּ י
פּידיען	פּ י ד י ע נ
פּידעלעך	פּ י ד ע ל ע כ
פּיזמען	פּ י ז מ ע נ
פּיזמױנעס	פּ י ז מ ױ נ ע ס
פּיטעם־האַקטױרעס	פּ י ט ע מ ה אַ ק ט ױ ר ע ס
פּיטשעװקעס	פּ י ט ש ע װ ק ע ס
פּילדערן	פּ י ל ד ע ר נ
פּילן	פּ י ל נ
פּינטלט	פּ י נ ט ל ט
פּינטעלעך	פּ י נ ט ע ל ע כ
פּיניע	פּ י נ י ע
פּיסק	פּ י ס ק
פּיסקעלעך	פּ י ס ק ע ל ע כ
פּיעסע	פּ י ע ס ע
פּיצל	פּ י צ ל
פּיקן	פּ י ק נ
פּיאַװקע	פּ י אַ װ ק ע
פּיאַװקעס	פּ י אַ װ ק ע ס
פּלו־	פּ ל ו
פּלודערן	פּ ל ו ד ע ר נ
פּלוצלונג	פּ ל ו צ ל ו נ ג
פּלוצלינג	פּ ל ו צ ל י נ ג
פּלוצעם	פּ ל ו צ ע מ
פּליעסק	פּ ל י ע ס ק
פּליאַמע	פּ ל י אַ מ ע
פּלעצער	פּ ל ע צ ע ר
פּלעװע	פּ ל ע װ ע
פּלױט	פּ ל ױ ט
פּלײטע	פּ ל ײ ט ע
פּלײן	פּ ל ײ נ
פּלײצע	פּ ל ײ צ ע
פּלײצעס	פּ ל ײ צ ע ס
פּלאַכטע	פּ ל אַ כ ט ע
פּלאַן	פּ ל אַ נ
פּלאַץ	פּ ל אַ צ
פּלאַצט	פּ ל אַ צ ט
פּלאַצן	פּ ל אַ צ נ
פּלאָצקער	פּ ל אָ צ ק ע ר
פּסורע	פּ ס ו ר ע
פּסורעס	פּ ס ו ר ע ס
פּסיכאָלאָגישע	פּ ס י כ אָ ל אָ ג י ש ע
פּסאַק	פּ ס אַ ק
פּעטעלעלע	פּ ע ט ע ל ע ל ע
פּעטש	פּ ע ט ש
פּעך	פּ ע כ
פּעלץ	פּ ע ל צ
פּעלצל	פּ ע ל צ ל
פּעלצלעך	פּ ע ל צ ל ע כ
פּעלצן	פּ ע ל צ נ
פּען	פּ ע נ
פּענעמל	פּ ע נ ע מ ל
פּענעמער	פּ ע נ ע מ ע ר
פּעסיע	פּ ע ס י ע
פּעסיען	פּ ע ס י ע נ
פּעסיעס	פּ ע ס י ע ס
פּעק	פּ ע ק
פּעקל	פּ ע ק ל
פּעקלעך	פּ ע ק ל ע כ
פּערזאָנען	פּ ע ר ז אָ נ ע נ
פּערי	פּ ע ר י
פּערל	פּ ע ר ל
פּערסישע	פּ ע ר ס י ש ע
פּערעץ	פּ ע ר ע צ
פּעראָנדעק	פּ ע ר אָ נ ד ע ק
פּרוטע	פּ ר ו ט ע
פּריזיװ	פּ ר י ז י װ
פּריטשעפּע	פּ ר י ט ש ע פּ ע
פּרימאַדאָנע	פּ ר י מ אַ ד אָ נ ע
פּרינץ	פּ ר י נ צ
פּרינציפּיעלער	פּ ר י נ צ י פּ י ע ל ע ר
פּרינצעסין	פּ ר י נ צ ע ס י נ
פּריצים	פּ ר י צ י מ
פּריציש	פּ ר י צ י ש
פּריצישער	פּ ר י צ י ש ע ר
פּריצע	פּ ר י צ ע
פּריקאַשטשיק	פּ ר י ק אַ ש ט ש י ק
פּרישטשיקלעך	פּ ר י ש ט ש י ק ל ע כ
פּרעגלט	פּ ר ע ג ל ט
פּרעגלען	פּ ר ע ג ל ע נ
פּרעזידענט	פּ ר ע ז י ד ע נ ט
פּרעזעס	פּ ר ע ז ע ס
פּרעטענזיע	פּ ר ע ט ע נ ז י ע
פּרעטענציע	פּ ר ע ט ע נ צ י ע
פּרעמיערע	פּ ר ע מ י ע ר ע
פּרײַז	פּ ר ײַ ז
פּראַקטיקע	פּ ר אַ ק ט י ק ע
פּראָבירן	פּ ר אָ ב י ר נ
פּראָבן	פּ ר אָ ב נ
פּראָבע	פּ ר אָ ב ע
פּראָבקעס	פּ ר אָ ב ק ע ס
פּראָטעסט	פּ ר אָ ט ע ס ט
פּראָסט	פּ ר אָ ס ט
פּראָסטן	פּ ר אָ ס ט נ
פּראָסטע	פּ ר אָ ס ט ע
פּראָסטער	פּ ר אָ ס ט ע ר
פּראָצענט	פּ ר אָ צ ע נ ט
פּראָשעניעס	פּ ר אָ ש ע נ י ע ס
פּראָשעק	פּ ר אָ ש ע ק
פּראָשקעס	פּ ר אָ ש ק ע ס
פּראָװיאַנט	פּ ר אָ װ י אַ נ ט
פּראָפֿעסאָר	פּ ר אָ פֿ ע ס אָ ר
פּרוּװ	פּ ר וּ װ
פּרוּװט	פּ ר וּ װ ט
פּרוּװן	פּ ר וּ װ נ
פּשאַ	פּ ש אַ
פּױזשעט	פּ ױ ז ש ע ט
פּױליש	פּ ױ ל י ש
פּױלן	פּ ױ ל נ
פּױער	פּ ױ ע ר
פּױערים	פּ ױ ע ר י מ
פּױעריש	פּ ױ ע ר י ש
פּױערישן	פּ ױ ע ר י ש נ
פּױערישע	פּ ױ ע ר י ש ע
פּױערן	פּ ױ ע ר נ
פּױערס	פּ ױ ע ר ס
פּײגערן	פּ ײ ג ע ר נ
פּײסי	פּ ײ ס י
פּײסעך	פּ ײ ס ע כ
פּײסעכדיקער	פּ ײ ס ע כ ד י ק ע ר
פּײעלעך	פּ ײ ע ל ע כ
פּײעס	פּ ײ ע ס
פּײרע	פּ ײ ר ע
פּײרעס	פּ ײ ר ע ס
פּײרעק	פּ ײ ר ע ק
פּײרעש	פּ ײ ר ע ש
פּאַזוכעס	פּ אַ ז ו כ ע ס
פּאַטש	פּ אַ ט ש
פּאַטשן	פּ אַ ט ש נ
פּאַטשקען	פּ אַ ט ש ק ע נ
פּאַכיר	פּ אַ כ י ר
פּאַכעד	פּ אַ כ ע ד
פּאַלטן	פּ אַ ל ט נ
פּאַלטאָ	פּ אַ ל ט אָ
פּאַלטאָס	פּ אַ ל ט אָ ס
פּאַלאַנט	פּ אַ ל אַ נ ט
פּאַלאַץ	פּ אַ ל אַ צ
פּאַמעלעך	פּ אַ מ ע ל ע כ
פּאַמעלעכן	פּ אַ מ ע ל ע כ נ
פּאַן	פּ אַ נ
פּאַנטאָפֿעלעך	פּ אַ נ ט אָ פֿ ע ל ע כ
פּאַניע	פּ אַ נ י ע
פּאַס	פּ אַ ס
פּאַסט	פּ אַ ס ט
פּאַסיק	פּ אַ ס י ק
פּאַסעליװשײַסיאַ	פּ אַ ס ע ל י װ ש ײַ ס י אַ
פּאַסעס	פּ אַ ס ע ס
פּאַסעק	פּ אַ ס ע ק
פּאַסקודנע	פּ אַ ס ק ו ד נ ע
פּאַסקנט	פּ אַ ס ק נ ט
פּאַסקעלעך	פּ אַ ס ק ע ל ע כ
פּאַסקענען	פּ אַ ס ק ע נ ע נ
פּאַק	פּ אַ ק
פּאַקט	פּ אַ ק ט
פּאַקן־טרעגער	פּ אַ ק נ ט ר ע ג ע ר
פּאַרנאָסע	פּ אַ ר נ אָ ס ע
פּאַרנאָסעס	פּ אַ ר נ אָ ס ע ס
פּאַרע	פּ אַ ר ע
פּאַרעװען	פּ אַ ר ע װ ע נ
פּאַרק	פּ אַ ר ק
פּאַרקאַן	פּ אַ ר ק אַ נ
פּאַרשױן	פּ אַ ר ש ױ נ
פּאַרשױנען	פּ אַ ר ש ױ נ ע נ
פּאַראַד	פּ אַ ר אַ ד
פּאַשע	פּ אַ ש ע
פּאַװאָלינקע	פּ אַ װ אָ ל י נ ק ע
פּאַװאָליע	פּ אַ װ אָ ל י ע
פּאַפּיר	פּ אַ פּ י ר
פּאַפּירן	פּ אַ פּ י ר נ
פּאַפּירעלעך	פּ אַ פּ י ר ע ל ע כ
פּאַפּיראָסן	פּ אַ פּ י ר אָ ס נ
פּאָגראָם	פּ אָ ג ר אָ מ
פּאָדלאָגע	פּ אָ ד ל אָ ג ע
פּאָדקאָװעס	פּ אָ ד ק אָ װ ע ס
פּאָדריאַטשיק	פּ אָ ד ר י אַ ט ש י ק
פּאָזע	פּ אָ ז ע
פּאָטער	פּ אָ ט ע ר
פּאָטשט	פּ אָ ט ש ט
פּאָליציע	פּ אָ ל י צ י ע
פּאָליצע	פּ אָ ל י צ ע
פּאָליצײ	פּ אָ ל י צ ײ
פּאָליאָסקע	פּ אָ ל י אָ ס ק ע
פּאָלניש	פּ אָ ל נ י ש
פּאָלע	פּ אָ ל ע
פּאָלעס	פּ אָ ל ע ס
פּאָמעניצע	פּ אָ מ ע נ י צ ע
פּאָמאָיעס	פּ אָ מ אָ י ע ס
פּאָנעם	פּ אָ נ ע מ
פּאָס־	פּ אָ ס
פּאָסט	פּ אָ ס ט
פּאָסל	פּ אָ ס ל
פּאָסעסאָר	פּ אָ ס ע ס אָ ר
פּאָסעק	פּ אָ ס ע ק
פּאָסקים	פּ אָ ס ק י מ
פּאָעזיע	פּ אָ ע ז י ע
פּאָר	פּ אָ ר
פּאָרטאָ	פּ אָ ר ט אָ
פּאָרל	פּ אָ ר ל
פּאָרן	פּ אָ ר נ
פּאָרעץ	פּ אָ ר ע צ
פּאָרעש	פּ אָ ר ע ש
פּאָשע־ייִסראָעל	פּ אָ ש ע י יִ ס ר אָ ע ל
פּאָשעט	פּ אָ ש ע ט
פּאָשעטע	פּ אָ ש ע ט ע
פּאָשעטער	פּ אָ ש ע ט ע ר
פּאָװידלע	פּ אָ װ י ד ל ע
פּאָפּערילע	פּ אָ פּ ע ר י ל ע
פּאָפּראַװקע	פּ אָ פּ ר אַ װ ק ע
פֿוטער	פֿ ו ט ע ר
פֿוטערן	פֿ ו ט ע ר נ
פֿוטערנעם	פֿ ו ט ע ר נ ע מ
פֿול	פֿ ו ל
פֿולן	פֿ ו ל נ
פֿולע	פֿ ו ל ע
פֿולער	פֿ ו ל ע ר
פֿון	פֿ ו נ
פֿונדעסטװעגן	פֿ ו נ ד ע ס ט װ ע ג נ
פֿונעם	פֿ ו נ ע מ
פֿונק	פֿ ו נ ק
פֿונקען	פֿ ו נ ק ע נ
פֿונאַנדערגעלאָזענע	פֿ ו נ אַ נ ד ע ר ג ע ל אָ ז ע נ ע
פֿוס	פֿ ו ס
פֿוסגײער	פֿ ו ס ג ײ ע ר
פֿוסנס	פֿ ו ס נ ס
פֿור	פֿ ו ר
פֿושער	פֿ ו ש ע ר
פֿופֿציק	פֿ ו פֿ צ י ק
פֿופֿצן	פֿ ו פֿ צ נ
פֿופֿצן־צװאַנציק	פֿ ו פֿ צ נ צ װ אַ נ צ י ק
פֿידל	פֿ י ד ל
פֿידעלע	פֿ י ד ע ל ע
פֿיטערן	פֿ י ט ע ר נ
פֿיל	פֿ י ל
פֿילט	פֿ י ל ט
פֿיליער	פֿ י ל י ע ר
פֿילנדיק	פֿ י ל נ ד י ק
פֿין־פֿײַן־פֿין	פֿ י נ פֿ ײַ נ פֿ י נ
פֿינגער	פֿ י נ ג ע ר
פֿינגערל	פֿ י נ ג ע ר ל
פֿינגערלעך	פֿ י נ ג ע ר ל ע כ
פֿינעף	פֿ י נ ע פֿ
פֿינף	פֿ י נ פֿ
פֿינף־און־זיבעציק	פֿ י נ פֿ ו נ ז י ב ע צ י ק
פֿינף־זעקס	פֿ י נ פֿ ז ע ק ס
פֿינצטער	פֿ י נ צ ט ע ר
פֿינצטערן	פֿ י נ צ ט ע ר נ
פֿינצטערניש	פֿ י נ צ ט ע ר נ י ש
פֿינצטערער	פֿ י נ צ ט ע ר ע ר
פֿינקלט	פֿ י נ ק ל ט
פֿינקלען	פֿ י נ ק ל ע נ
פֿינאַנץ־מיניסטער	פֿ י נ אַ נ צ מ י נ י ס ט ע ר
פֿינפֿערל	פֿ י נ פֿ ע ר ל
פֿיס	פֿ י ס
פֿיסל	פֿ י ס ל
פֿיסלעך	פֿ י ס ל ע כ
פֿיר	פֿ י ר
פֿיר־און־זיבעציק	פֿ י ר ו נ ז י ב ע צ י ק
פֿיר־עקנדיקן	פֿ י ר ע ק נ ד י ק נ
פֿיר־קאַנטיקן	פֿ י ר ק אַ נ ט י ק נ
פֿירט	פֿ י ר ט
פֿירמע	פֿ י ר מ ע
פֿירן	פֿ י ר נ
פֿירקאַנטיק	פֿ י ר ק אַ נ ט י ק
פֿיש	פֿ י ש
פֿישטשאַלקע	פֿ י ש ט ש אַ ל ק ע
פֿישערס	פֿ י ש ע ר ס
פֿלוס	פֿ ל ו ס
פֿלי	פֿ ל י
פֿליגל	פֿ ל י ג ל
פֿליגלען	פֿ ל י ג ל ע נ
פֿליגן	פֿ ל י ג נ
פֿליגעלעך	פֿ ל י ג ע ל ע כ
פֿליט	פֿ ל י ט
פֿלינק	פֿ ל י נ ק
פֿלינקער	פֿ ל י נ ק ע ר
פֿליסטו	פֿ ל י ס ט ו
פֿליאַסקעט	פֿ ל י אַ ס ק ע ט
פֿלעג	פֿ ל ע ג
פֿלעגט	פֿ ל ע ג ט
פֿלעגן	פֿ ל ע ג נ
פֿלעכטלעך	פֿ ל ע כ ט ל ע כ
פֿלעכטן	פֿ ל ע כ ט נ
פֿלעק	פֿ ל ע ק
פֿלעקט	פֿ ל ע ק ט
פֿלעשל	פֿ ל ע ש ל
פֿלעשלעך	פֿ ל ע ש ל ע כ
פֿלעשלעכװײַז	פֿ ל ע ש ל ע כ װ ײַ ז
פֿלעשעלע	פֿ ל ע ש ע ל ע
פֿלעשעלעך	פֿ ל ע ש ע ל ע כ
פֿלעשער	פֿ ל ע ש ע ר
פֿלױם	פֿ ל ױ מ
פֿלױמען	פֿ ל ױ מ ע נ
פֿלײש	פֿ ל ײ ש
פֿלײשיק	פֿ ל ײ ש י ק
פֿלײשיקן	פֿ ל ײ ש י ק נ
פֿלײשיקע	פֿ ל ײ ש י ק ע
פֿליִען	פֿ ל יִ ע נ
פֿלײַס	פֿ ל ײַ ס
פֿלאַטערט	פֿ ל אַ ט ע ר ט
פֿלאַם	פֿ ל אַ מ
פֿלאַמען	פֿ ל אַ מ ע נ
פֿלאַקערט	פֿ ל אַ ק ע ר ט
פֿלאַש	פֿ ל אַ ש
פֿעדער	פֿ ע ד ע ר
פֿעדערל	פֿ ע ד ע ר ל
פֿעדערלעך	פֿ ע ד ע ר ל ע כ
פֿעדערן	פֿ ע ד ע ר נ
פֿעטע	פֿ ע ט ע
פֿעטער	פֿ ע ט ע ר
פֿעל	פֿ ע ל
פֿעלד	פֿ ע ל ד
פֿעלדבלומען	פֿ ע ל ד ב ל ו מ ע נ
פֿעלדער	פֿ ע ל ד ע ר
פֿעלז	פֿ ע ל ז
פֿעלט	פֿ ע ל ט
פֿעלן	פֿ ע ל נ
פֿענצטער	פֿ ע נ צ ט ע ר
פֿענצטערל	פֿ ע נ צ ט ע ר ל
פֿענצטערלעך	פֿ ע נ צ ט ע ר ל ע כ
פֿעסט	פֿ ע ס ט
פֿעסל	פֿ ע ס ל
פֿערד	פֿ ע ר ד
פֿערדיונגס	פֿ ע ר ד י ו נ ג ס
פֿערדל	פֿ ע ר ד ל
פֿערדלס	פֿ ע ר ד ל ס
פֿערדלעך	פֿ ע ר ד ל ע כ
פֿערדמאַרק	פֿ ע ר ד מ אַ ר ק
פֿערדס	פֿ ע ר ד ס
פֿערדעלע	פֿ ע ר ד ע ל ע
פֿערטל	פֿ ע ר ט ל
פֿערטן	פֿ ע ר ט נ
פֿערציק	פֿ ע ר צ י ק
פֿערציק־פֿופֿציק	פֿ ע ר צ י ק פֿ ו פֿ צ י ק
פֿערצנטער	פֿ ע ר צ נ ט ע ר
פֿערשקע	פֿ ע ר ש ק ע
פֿערשקעס	פֿ ע ר ש ק ע ס
פֿעװראַלסקע־רעװאָלוציע	פֿ ע װ ר אַ ל ס ק ע ר ע װ אָ ל ו צ י ע
פֿעפֿער	פֿ ע פֿ ע ר
פֿרוכט	פֿ ר ו כ ט
פֿרום	פֿ ר ו מ
פֿרומע	פֿ ר ו מ ע
פֿרומער	פֿ ר ו מ ע ר
פֿרי	פֿ ר י
פֿרידן	פֿ ר י ד נ
פֿרילינג	פֿ ר י ל י נ ג
פֿרילינגנאַכט	פֿ ר י ל י נ ג נ אַ כ ט
פֿרילינגס־מאָרגן	פֿ ר י ל י נ ג ס מ אָ ר ג נ
פֿרילינגסטאָג	פֿ ר י ל י נ ג ס ט אָ ג
פֿרימאָרגן	פֿ ר י מ אָ ר ג נ
פֿרימאָרגנדיקע	פֿ ר י מ אָ ר ג נ ד י ק ע
פֿרישן	פֿ ר י ש נ
פֿרישע	פֿ ר י ש ע
פֿרישער	פֿ ר י ש ע ר
פֿרעג	פֿ ר ע ג
פֿרעגט	פֿ ר ע ג ט
פֿרעגן	פֿ ר ע ג נ
פֿרעגנדיק	פֿ ר ע ג נ ד י ק
פֿרעמד	פֿ ר ע מ ד
פֿרעמדן	פֿ ר ע מ ד נ
פֿרעמדע	פֿ ר ע מ ד ע
פֿרעמדער	פֿ ר ע מ ד ע ר
פֿרעסט	פֿ ר ע ס ט
פֿרעסנדיק	פֿ ר ע ס נ ד י ק
פֿרױ	פֿ ר ױ
פֿרײ	פֿ ר ײ
פֿרײד	פֿ ר ײ ד
פֿרײט	פֿ ר ײ ט
פֿרײלעך	פֿ ר ײ ל ע כ
פֿרײלעכן	פֿ ר ײ ל ע כ נ
פֿרײלעכע	פֿ ר ײ ל ע כ ע
פֿרײלעכער	פֿ ר ײ ל ע כ ע ר
פֿרײען	פֿ ר ײ ע נ
פֿריִען	פֿ ר יִ ע נ
פֿריִער	פֿ ר יִ ע ר
פֿריִערדיקע	פֿ ר יִ ע ר ד י ק ע
פֿריִערדיקער	פֿ ר יִ ע ר ד י ק ע ר
פֿריִעריקע	פֿ ר יִ ע ר י ק ע
פֿרײַ	פֿ ר ײַ
פֿרײַטיק	פֿ ר ײַ ט י ק
פֿרײַטיק־צו־נאַכטס	פֿ ר ײַ ט י ק צ ו נ אַ כ ט ס
פֿרײַנדלעך	פֿ ר ײַ נ ד ל ע כ
פֿרײַנדלעכע	פֿ ר ײַ נ ד ל ע כ ע
פֿרײַנדשאַפֿט	פֿ ר ײַ נ ד ש אַ פֿ ט
פֿרײַנט	פֿ ר ײַ נ ט
פֿרײַע	פֿ ר ײַ ע
פֿרײַער	פֿ ר ײַ ע ר
פֿראַגן	פֿ ר אַ ג נ
פֿראַגע	פֿ ר אַ ג ע
פֿראַנצױזיש	פֿ ר אַ נ צ ױ ז י ש
פֿראַנק	פֿ ר אַ נ ק
פֿראַסק	פֿ ר אַ ס ק
פֿראָסט	פֿ ר אָ ס ט
פֿױגל	פֿ ױ ג ל
פֿױגלען	פֿ ױ ג ל ע נ
פֿױגעלעך	פֿ ױ ג ע ל ע כ
פֿױלט	פֿ ױ ל ט
פֿױלן	פֿ ױ ל נ
פֿױסט	פֿ ױ ס ט
פֿײגלעך	פֿ ײ ג ל ע כ
פֿײגע־לײע	פֿ ײ ג ע ל ײ ע
פֿײַטלען	פֿ ײַ ט ל ע נ
פֿײַכטע	פֿ ײַ כ ט ע
פֿײַל	פֿ ײַ ל
פֿײַלן־בױגנס	פֿ ײַ ל נ ב ױ ג נ ס
פֿײַן	פֿ ײַ נ
פֿײַן־פֿין	פֿ ײַ נ פֿ י נ
פֿײַן־פֿין־פֿײַן	פֿ ײַ נ פֿ י נ פֿ ײַ נ
פֿײַנדע	פֿ ײַ נ ד ע
פֿײַנט	פֿ ײַ נ ט
פֿײַנטשיק	פֿ ײַ נ ט ש י ק
פֿײַנע	פֿ ײַ נ ע
פֿײַנער	פֿ ײַ נ ע ר
פֿײַנשמעקער	פֿ ײַ נ ש מ ע ק ע ר
פֿײַנפֿינקלקרױט	פֿ ײַ נ פֿ י נ ק ל ק ר ױ ט
פֿײַער	פֿ ײַ ע ר
פֿײַער־קנאַקן	פֿ ײַ ע ר ק נ אַ ק נ
פֿײַערדיק	פֿ ײַ ע ר ד י ק
פֿײַערדיקן	פֿ ײַ ע ר ד י ק נ
פֿײַערדיקע	פֿ ײַ ע ר ד י ק ע
פֿײַערט	פֿ ײַ ע ר ט
פֿײַערל	פֿ ײַ ע ר ל
פֿײַערן	פֿ ײַ ע ר נ
פֿײַערקע	פֿ ײַ ע ר ק ע
פֿײַערפֿלאַם	פֿ ײַ ע ר פֿ ל אַ מ
פֿײַפֿער	פֿ ײַ פֿ ע ר
פֿאַ	פֿ אַ
פֿאַבריקע	פֿ אַ ב ר י ק ע
פֿאַטשײלע	פֿ אַ ט ש ײ ל ע
פֿאַטשײלקעס	פֿ אַ ט ש ײ ל ק ע ס
פֿאַל	פֿ אַ ל
פֿאַל־	פֿ אַ ל
פֿאַלד	פֿ אַ ל ד
פֿאַלדן	פֿ אַ ל ד נ
פֿאַלט	פֿ אַ ל ט
פֿאַלן	פֿ אַ ל נ
פֿאַלשע	פֿ אַ ל ש ע
פֿאַמיליע	פֿ אַ מ י ל י ע
פֿאַמיליעס	פֿ אַ מ י ל י ע ס
פֿאַנטאַזירן	פֿ אַ נ ט אַ ז י ר נ
פֿאַס	פֿ אַ ס
פֿאַסטן	פֿ אַ ס ט נ
פֿאַקטן	פֿ אַ ק ט נ
פֿאַקלדיקע	פֿ אַ ק ל ד י ק ע
פֿאַר	פֿ אַ ר
פֿאַר־	פֿ אַ ר
פֿאַר־פּורים־טאָג	פֿ אַ ר פּ ו ר י מ ט אָ ג
פֿאַר־פּײסעך	פֿ אַ ר פּ ײ ס ע כ
פֿאַראומערט	פֿ אַ ר ו מ ע ר ט
פֿאַראומערן	פֿ אַ ר ו מ ע ר נ
פֿאַראיבל	פֿ אַ ר י ב ל
פֿאַרבונדן	פֿ אַ ר ב ו נ ד נ
פֿאַרבליבן	פֿ אַ ר ב ל י ב נ
פֿאַרבלענדט	פֿ אַ ר ב ל ע נ ד ט
פֿאַרבלאָזן	פֿ אַ ר ב ל אָ ז נ
פֿאַרבלאָטיקטע	פֿ אַ ר ב ל אָ ט י ק ט ע
פֿאַרבלאָנדזשעט	פֿ אַ ר ב ל אָ נ ד ז ש ע ט
פֿאַרבן	פֿ אַ ר ב נ
פֿאַרבעטן	פֿ אַ ר ב ע ט נ
פֿאַרברעכט	פֿ אַ ר ב ר ע כ ט
פֿאַרברענגט	פֿ אַ ר ב ר ע נ ג ט
פֿאַרברענגען	פֿ אַ ר ב ר ע נ ג ע נ
פֿאַרברענט	פֿ אַ ר ב ר ע נ ט
פֿאַרבראַכט	פֿ אַ ר ב ר אַ כ ט
פֿאַרבײַ	פֿ אַ ר ב ײַ
פֿאַרבײַגעפֿלױגן	פֿ אַ ר ב ײַ ג ע פֿ ל ױ ג נ
פֿאַרבאָרגענע	פֿ אַ ר ב אָ ר ג ע נ ע
פֿאַרגינט	פֿ אַ ר ג י נ ט
פֿאַרגלוסט	פֿ אַ ר ג ל ו ס ט
פֿאַרגלײזט	פֿ אַ ר ג ל ײ ז ט
פֿאַרגלײזנדיק	פֿ אַ ר ג ל ײ ז נ ד י ק
פֿאַרגלײַכן	פֿ אַ ר ג ל ײַ כ נ
פֿאַרגעניגן	פֿ אַ ר ג ע נ י ג נ
פֿאַרגעס	פֿ אַ ר ג ע ס
פֿאַרגעסן	פֿ אַ ר ג ע ס נ
פֿאַרגעסנדיק	פֿ אַ ר ג ע ס נ ד י ק
פֿאַרגעסענע	פֿ אַ ר ג ע ס ע נ ע
פֿאַרגעסענעס	פֿ אַ ר ג ע ס ע נ ע ס
פֿאַרגעסענער	פֿ אַ ר ג ע ס ע נ ע ר
פֿאַרגאַפֿט	פֿ אַ ר ג אַ פֿ ט
פֿאַרדין	פֿ אַ ר ד י נ
פֿאַרדינט	פֿ אַ ר ד י נ ט
פֿאַרדינסט	פֿ אַ ר ד י נ ס ט
פֿאַרדינען	פֿ אַ ר ד י נ ע נ
פֿאַרדעקטן	פֿ אַ ר ד ע ק ט נ
פֿאַרדריסט	פֿ אַ ר ד ר י ס ט
פֿאַרדריפּעטע	פֿ אַ ר ד ר י פּ ע ט ע
פֿאַרדרײט	פֿ אַ ר ד ר ײ ט
פֿאַרדרײטן	פֿ אַ ר ד ר ײ ט נ
פֿאַרדרײען	פֿ אַ ר ד ר ײ ע נ
פֿאַרדראָסן	פֿ אַ ר ד ר אָ ס נ
פֿאַרהוסטן	פֿ אַ ר ה ו ס ט נ
פֿאַרהילט	פֿ אַ ר ה י ל ט
פֿאַרהערט	פֿ אַ ר ה ע ר ט
פֿאַרהערן	פֿ אַ ר ה ע ר נ
פֿאַרהױלן	פֿ אַ ר ה ױ ל נ
פֿאַרהאַלטן	פֿ אַ ר ה אַ ל ט נ
פֿאַרהאַנדלט	פֿ אַ ר ה אַ נ ד ל ט
פֿאַרזוכט	פֿ אַ ר ז ו כ ט
פֿאַרזוכן	פֿ אַ ר ז ו כ נ
פֿאַרזונקען	פֿ אַ ר ז ו נ ק ע נ
פֿאַרזינדיק	פֿ אַ ר ז י נ ד י ק
פֿאַרזינדיקן	פֿ אַ ר ז י נ ד י ק נ
פֿאַרזעצן	פֿ אַ ר ז ע צ נ
פֿאַרזאַמלט	פֿ אַ ר ז אַ מ ל ט
פֿאַרזאָרגט	פֿ אַ ר ז אָ ר ג ט
פֿאַרזאָרגן	פֿ אַ ר ז אָ ר ג נ
פֿאַרטוך	פֿ אַ ר ט ו כ
פֿאַרטומלטער	פֿ אַ ר ט ו מ ל ט ע ר
פֿאַרטומלען	פֿ אַ ר ט ו מ ל ע נ
פֿאַרטון	פֿ אַ ר ט ו נ
פֿאַרטונקט	פֿ אַ ר ט ו נ ק ט
פֿאַרטונקען	פֿ אַ ר ט ו נ ק ע נ
פֿאַרטיק	פֿ אַ ר ט י ק
פֿאַרטיקער	פֿ אַ ר ט י ק ע ר
פֿאַרטיפֿן	פֿ אַ ר ט י פֿ נ
פֿאַרטעך	פֿ אַ ר ט ע כ
פֿאַרטרונקען	פֿ אַ ר ט ר ו נ ק ע נ
פֿאַרטרינקט	פֿ אַ ר ט ר י נ ק ט
פֿאַרטרינקען	פֿ אַ ר ט ר י נ ק ע נ
פֿאַרטרױט	פֿ אַ ר ט ר ױ ט
פֿאַרטרײַב	פֿ אַ ר ט ר ײַ ב
פֿאַרטראַכט	פֿ אַ ר ט ר אַ כ ט
פֿאַרטשעפּע	פֿ אַ ר ט ש ע פּ ע
פֿאַרטױשן	פֿ אַ ר ט ױ ש נ
פֿאַרטאַרעראַמעט	פֿ אַ ר ט אַ ר ע ר אַ מ ע ט
פֿאַרטאָג	פֿ אַ ר ט אָ ג
פֿאַרטאָגס	פֿ אַ ר ט אָ ג ס
פֿאַרטאָן	פֿ אַ ר ט אָ נ
פֿאַריאָגן	פֿ אַ ר י אָ ג נ
פֿאַרכאַסמעטן	פֿ אַ ר כ אַ ס מ ע ט נ
פֿאַרכאַפּט	פֿ אַ ר כ אַ פּ ט
פֿאַרליבט	פֿ אַ ר ל י ב ט
פֿאַרלירן	פֿ אַ ר ל י ר נ
פֿאַרלעגער	פֿ אַ ר ל ע ג ע ר
פֿאַרלױרן	פֿ אַ ר ל ױ ר נ
פֿאַרלײגט	פֿ אַ ר ל ײ ג ט
פֿאַרלאַנג	פֿ אַ ר ל אַ נ ג
פֿאַרלאַנגט	פֿ אַ ר ל אַ נ ג ט
פֿאַרלאַנגען	פֿ אַ ר ל אַ נ ג ע נ
פֿאַרלאָז	פֿ אַ ר ל אָ ז
פֿאַרלאָזט	פֿ אַ ר ל אָ ז ט
פֿאַרלאָזטע	פֿ אַ ר ל אָ ז ט ע
פֿאַרלאָזן	פֿ אַ ר ל אָ ז נ
פֿאַרלאָפֿן	פֿ אַ ר ל אָ פֿ נ
פֿאַרמישפּעט	פֿ אַ ר מ י ש פּ ע ט
פֿאַרמעגן	פֿ אַ ר מ ע ג נ
פֿאַרמאַכט	פֿ אַ ר מ אַ כ ט
פֿאַרמאָג	פֿ אַ ר מ אָ ג
פֿאַרמאָגט	פֿ אַ ר מ אָ ג ט
פֿאַרמאָגן	פֿ אַ ר מ אָ ג נ
פֿאַרן	פֿ אַ ר נ
פֿאַרנומען	פֿ אַ ר נ ו מ ע נ
פֿאַרניכטן	פֿ אַ ר נ י כ ט נ
פֿאַרנאַכט	פֿ אַ ר נ אַ כ ט
פֿאַרנאַכטלעך	פֿ אַ ר נ אַ כ ט ל ע כ
פֿאַרנאַכטן	פֿ אַ ר נ אַ כ ט נ
פֿאַרנאַרן	פֿ אַ ר נ אַ ר נ
פֿאַרסאַמטע	פֿ אַ ר ס אַ מ ט ע
פֿאַרסאָפּעט	פֿ אַ ר ס אָ פּ ע ט
פֿאַרענטפֿערט	פֿ אַ ר ע נ ט פֿ ע ר ט
פֿאַרענטפֿערן	פֿ אַ ר ע נ ט פֿ ע ר נ
פֿאַרצוקט	פֿ אַ ר צ ו ק ט
פֿאַרציט	פֿ אַ ר צ י ט
פֿאַרצערן	פֿ אַ ר צ ע ר נ
פֿאַרצאָרעט	פֿ אַ ר צ אָ ר ע ט
פֿאַרקילונג	פֿ אַ ר ק י ל ו נ ג
פֿאַרקילן	פֿ אַ ר ק י ל נ
פֿאַרקלעמט	פֿ אַ ר ק ל ע מ ט
פֿאַרקלערט	פֿ אַ ר ק ל ע ר ט
פֿאַרקלאַפּט	פֿ אַ ר ק ל אַ פּ ט
פֿאַרקלאָגט	פֿ אַ ר ק ל אָ ג ט
פֿאַרקניפּט	פֿ אַ ר ק נ י פּ ט
פֿאַרקנײטשט	פֿ אַ ר ק נ ײ ט ש ט
פֿאַרקנאָטן	פֿ אַ ר ק נ אָ ט נ
פֿאַרקעמט	פֿ אַ ר ק ע מ ט
פֿאַרקערט	פֿ אַ ר ק ע ר ט
פֿאַרקריכן	פֿ אַ ר ק ר י כ נ
פֿאַרקרימט	פֿ אַ ר ק ר י מ ט
פֿאַרקרימטע	פֿ אַ ר ק ר י מ ט ע
פֿאַרקראָכן	פֿ אַ ר ק ר אָ כ נ
פֿאַרקױפֿט	פֿ אַ ר ק ױ פֿ ט
פֿאַרקױפֿן	פֿ אַ ר ק ױ פֿ נ
פֿאַרקײטלען	פֿ אַ ר ק ײ ט ל ע נ
פֿאַרקאַטשע	פֿ אַ ר ק אַ ט ש ע
פֿאַרקאָװעטן	פֿ אַ ר ק אָ װ ע ט נ
פֿאַררוקט	פֿ אַ ר ר ו ק ט
פֿאַררוקן	פֿ אַ ר ר ו ק נ
פֿאַרריכט	פֿ אַ ר ר י כ ט
פֿאַרריסן	פֿ אַ ר ר י ס נ
פֿאַררעדט	פֿ אַ ר ר ע ד ט
פֿאַרשטומט	פֿ אַ ר ש ט ו מ ט
פֿאַרשטומען	פֿ אַ ר ש ט ו מ ע נ
פֿאַרשטעלט	פֿ אַ ר ש ט ע ל ט
פֿאַרשטעלטער	פֿ אַ ר ש ט ע ל ט ע ר
פֿאַרשטעלן	פֿ אַ ר ש ט ע ל נ
פֿאַרשטעקט	פֿ אַ ר ש ט ע ק ט
פֿאַרשטערט	פֿ אַ ר ש ט ע ר ט
פֿאַרשטײ	פֿ אַ ר ש ט ײ
פֿאַרשטײט	פֿ אַ ר ש ט ײ ט
פֿאַרשטײן	פֿ אַ ר ש ט ײ נ
פֿאַרשטײענדיק	פֿ אַ ר ש ט ײ ע נ ד י ק
פֿאַרשטאַנד	פֿ אַ ר ש ט אַ נ ד
פֿאַרשטאַנען	פֿ אַ ר ש ט אַ נ ע נ
פֿאַרשטאַרט	פֿ אַ ר ש ט אַ ר ט
פֿאַרשידענע	פֿ אַ ר ש י ד ע נ ע
פֿאַרשילטן	פֿ אַ ר ש י ל ט נ
פֿאַרשימלט	פֿ אַ ר ש י מ ל ט
פֿאַרשליס	פֿ אַ ר ש ל י ס
פֿאַרשליסט	פֿ אַ ר ש ל י ס ט
פֿאַרשליסן	פֿ אַ ר ש ל י ס נ
פֿאַרשלאָגן	פֿ אַ ר ש ל אָ ג נ
פֿאַרשלאָסן	פֿ אַ ר ש ל אָ ס נ
פֿאַרשלאָפֿן	פֿ אַ ר ש ל אָ פֿ נ
פֿאַרשלאָפֿענעם	פֿ אַ ר ש ל אָ פֿ ע נ ע מ
פֿאַרשמירט	פֿ אַ ר ש מ י ר ט
פֿאַרשמירטע	פֿ אַ ר ש מ י ר ט ע
פֿאַרשנײט	פֿ אַ ר ש נ ײ ט
פֿאַרשעמט	פֿ אַ ר ש ע מ ט
פֿאַרשעמטן	פֿ אַ ר ש ע מ ט נ
פֿאַרשעמטערהײט	פֿ אַ ר ש ע מ ט ע ר ה ײ ט
פֿאַרשריבן	פֿ אַ ר ש ר י ב נ
פֿאַרשרײַבט	פֿ אַ ר ש ר ײַ ב ט
פֿאַרשרײַבן	פֿ אַ ר ש ר ײַ ב נ
פֿאַרשװינדט	פֿ אַ ר ש װ י נ ד ט
פֿאַרשװינדן	פֿ אַ ר ש װ י נ ד נ
פֿאַרשװיצט	פֿ אַ ר ש װ י צ ט
פֿאַרשװיצטער	פֿ אַ ר ש װ י צ ט ע ר
פֿאַרשװאַרצט	פֿ אַ ר ש װ אַ ר צ ט
פֿאַרשװוּנדן	פֿ אַ ר ש װ וּ נ ד נ
פֿאַרשאָטן	פֿ אַ ר ש אָ ט נ
פֿאַרשאָלטן	פֿ אַ ר ש אָ ל ט נ
פֿאַרשפּילט	פֿ אַ ר ש פּ י ל ט
פֿאַרשפּעטיקן	פֿ אַ ר ש פּ ע ט י ק נ
פֿאַרשפּרײט	פֿ אַ ר ש פּ ר ײ ט
פֿאַרשפּרײטן	פֿ אַ ר ש פּ ר ײ ט נ
פֿאַרשפּאַרט	פֿ אַ ר ש פּ אַ ר ט
פֿאַרשפּאָלטן	פֿ אַ ר ש פּ אָ ל ט נ
פֿאַרשפּאָרט	פֿ אַ ר ש פּ אָ ר ט
פֿאַרװיקלט	פֿ אַ ר װ י ק ל ט
פֿאַרװאַרפֿט	פֿ אַ ר װ אַ ר פֿ ט
פֿאַרװאַרפֿן	פֿ אַ ר װ אַ ר פֿ נ
פֿאַרװאָגלט	פֿ אַ ר װ אָ ג ל ט
פֿאַרװאָרפֿן	פֿ אַ ר װ אָ ר פֿ נ
פֿאַרװאָרפֿענע	פֿ אַ ר װ אָ ר פֿ ע נ ע
פֿאַרװוּנדערט	פֿ אַ ר װ וּ נ ד ע ר ט
פֿאַראַן	פֿ אַ ר אַ נ
פֿאַרפּלאָנטערט	פֿ אַ ר פּ ל אָ נ ט ע ר ט
פֿאַרפּלאָנטעװעט	פֿ אַ ר פּ ל אָ נ ט ע װ ע ט
פֿאַרפּאַסקודיקט	פֿ אַ ר פּ אַ ס ק ו ד י ק ט
פֿאַרפּאַקט	פֿ אַ ר פּ אַ ק ט
פֿאַרפֿולט	פֿ אַ ר פֿ ו ל ט
פֿאַרפֿונדעװעט	פֿ אַ ר פֿ ו נ ד ע װ ע ט
פֿאַרפֿינצטערט	פֿ אַ ר פֿ י נ צ ט ע ר ט
פֿאַרפֿירן	פֿ אַ ר פֿ י ר נ
פֿאַרפֿלײצן	פֿ אַ ר פֿ ל ײ צ נ
פֿאַרפֿלאַמט	פֿ אַ ר פֿ ל אַ מ ט
פֿאַרפֿלאָכטן	פֿ אַ ר פֿ ל אָ כ ט נ
פֿאַרפֿעסטיקט	פֿ אַ ר פֿ ע ס ט י ק ט
פֿאַרפֿרױרן	פֿ אַ ר פֿ ר ױ ר נ
פֿאַרפֿרױרענעם	פֿ אַ ר פֿ ר ױ ר ע נ ע מ
פֿאַרפֿױלט	פֿ אַ ר פֿ ױ ל ט
פֿאַרפֿאַלן	פֿ אַ ר פֿ אַ ל נ
פֿאַרפֿאַלענע	פֿ אַ ר פֿ אַ ל ע נ ע
פֿאַרפֿאַסער	פֿ אַ ר פֿ אַ ס ע ר
פֿאַרפֿאָרן	פֿ אַ ר פֿ אָ ר נ
פֿאָב־שמאָב	פֿ אָ ב ש מ אָ ב
פֿאָדעם	פֿ אָ ד ע מ
פֿאָדערט	פֿ אָ ד ע ר ט
פֿאָדערשטן	פֿ אָ ד ע ר ש ט נ
פֿאָטער	פֿ אָ ט ע ר
פֿאָטערס	פֿ אָ ט ע ר ס
פֿאָטערשטול	פֿ אָ ט ע ר ש ט ו ל
פֿאָטעפֿאַלנעסט	פֿ אָ ט ע פֿ אַ ל נ ע ס ט
פֿאָטאָגראַפֿיע	פֿ אָ ט אָ ג ר אַ פֿ י ע
פֿאָכט	פֿ אָ כ ט
פֿאָכען	פֿ אָ כ ע נ
פֿאָכערדיקע	פֿ אָ כ ע ר ד י ק ע
פֿאָלג	פֿ אָ ל ג
פֿאָלגן	פֿ אָ ל ג נ
פֿאָלק	פֿ אָ ל ק
פֿאָן	פֿ אָ נ
פֿאָקוסן	פֿ אָ ק ו ס נ
פֿאָר	פֿ אָ ר
פֿאָרהײַזל	פֿ אָ ר ה ײַ ז ל
פֿאָרהאַנגען	פֿ אָ ר ה אַ נ ג ע נ
פֿאָרזיכטיק	פֿ אָ ר ז י כ ט י ק
פֿאָרט	פֿ אָ ר ט
פֿאָרטקע	פֿ אָ ר ט ק ע
פֿאָרמע	פֿ אָ ר מ ע
פֿאָרן	פֿ אָ ר נ
פֿאָרנדיק	פֿ אָ ר נ ד י ק
פֿאָרנט	פֿ אָ ר נ ט
פֿאָרסטו	פֿ אָ ר ס ט ו
פֿאָרעם	פֿ אָ ר ע מ
פֿאָרקומען	פֿ אָ ר ק ו מ ע נ
פֿאָרױס	פֿ אָ ר ױ ס
