א	א
א־א	א א
אא	א א
אאא	א א א
אב־בית־דין	א ב ב י ת ד י נ
אבי	א ב י
אבי־יתומים	א ב י י ת ו מ י מ
אביי	א ב י י
אבינו	א ב י נ ו
אביסל	א ב י ס ל
אבן־טוב	א ב נ ט ו ב
אבן־עזרא	א ב נ ע ז ר א
אבער	א ב ע ר
אבר	א ב ר
אברהם	א ב ר ה מ
אברהם־אבינו־סנדקאות	א ב ר ה מ א ב י נ ו ס נ ד ק א ו ת
אגאוו	א ג א ו ו
אגרעסן	א ג ר ע ס נ
אדוואקאט	א ד ו ו א ק א ט
אדיע	א ד י ע
אדיר	א ד י ר
אדלער	א ד ל ע ר
אדעם	א ד ע מ
אדער	א ד ע ר
אדרבה	א ד ר ב ה
אדרעס	א ד ר ע ס
אהא	א ה א
אהיים	א ה י י מ
אהיימאיילן	א ה י י מ א י י ל נ
אהיימצוגיין	א ה י י מ צ ו ג י י נ
אהין	א ה י נ
אהינגעקומען	א ה י נ ג ע ק ו מ ע נ
אהינטער	א ה י נ ט ע ר
אהינצוטון	א ה י נ צ ו ט ו נ
אהער	א ה ע ר
אהערברענגען	א ה ע ר ב ר ע נ ג ע נ
אהרן	א ה ר נ
אהרן־ליב	א ה ר נ ל י ב
אהרן־ליבס	א ה ר נ ל י ב ס
אהרן־לייב	א ה ר נ ל י י ב
אואוועזכוס־זעה	א ו א ו ו ע ז כ ו ס ז ע ה
אוגערקעלעך	א ו ג ע ר ק ע ל ע כ
אוהב־ישראל	א ו ה ב י ש ר א ל
אווא	א ו ו א
אוואנטי	א ו ו א נ ט י
אוודאי	א ו ו ד א י
אווין	א ו ו י נ
אוונט	א ו ו נ ט
אוועק	א ו ו ע ק
אוועקגעבן	א ו ו ע ק ג ע ב נ
אוועקגעגאנגען	א ו ו ע ק ג ע ג א נ ג ע נ
אוועקגעגעבן	א ו ו ע ק ג ע ג ע ב נ
אוועקגעווארפן	א ו ו ע ק ג ע ו ו א ר פ נ
אוועקגעזעצט	א ו ו ע ק ג ע ז ע צ ט
אוועקגעלאפן	א ו ו ע ק ג ע ל א פ נ
אוועקגעלייגט	א ו ו ע ק ג ע ל י י ג ט
אוועקגענומען	א ו ו ע ק ג ע נ ו מ ע נ
אוועקגעפארן	א ו ו ע ק ג ע פ א ר נ
אוועקגעפלויגן	א ו ו ע ק ג ע פ ל ו י ג נ
אוועקגעקויפט	א ו ו ע ק ג ע ק ו י פ ט
אוועקגערופן	א ו ו ע ק ג ע ר ו פ נ
אוועקגערוקט	א ו ו ע ק ג ע ר ו ק ט
אוועקגעשוואומען	א ו ו ע ק ג ע ש ו ו א ו מ ע נ
אוועקגעשטופט	א ו ו ע ק ג ע ש ט ו פ ט
אוועקגעשטעלט	א ו ו ע ק ג ע ש ט ע ל ט
אוועקגעשיקט	א ו ו ע ק ג ע ש י ק ט
אוועקגעשפרונגען	א ו ו ע ק ג ע ש פ ר ו נ ג ע נ
אוועקזעצן	א ו ו ע ק ז ע צ נ
אוועקטראגן	א ו ו ע ק ט ר א ג נ
אוועקמאכן	א ו ו ע ק מ א כ נ
אוועקנעמען	א ו ו ע ק נ ע מ ע נ
אוועקנעמענדיג	א ו ו ע ק נ ע מ ע נ ד י ג
אוועקצולייגן	א ו ו ע ק צ ו ל י י ג נ
אוועקצוקוילען	א ו ו ע ק צ ו ק ו י ל ע נ
אוועקשטעלן	א ו ו ע ק ש ט ע ל נ
אוועקשליידערן	א ו ו ע ק ש ל י י ד ע ר נ
אוי	א ו י
אוי־וויי	א ו י ו ו י י
אויב	א ו י ב
אויבן	א ו י ב נ
אויבן־אן	א ו י ב נ א נ
אויבנאן	א ו י ב נ א נ
אויבער־שומר	א ו י ב ע ר ש ו מ ר
אויבערדעק	א ו י ב ע ר ד ע ק
אויבערשטן	א ו י ב ע ר ש ט נ
אויבערשטע	א ו י ב ע ר ש ט ע
אויבערשטער	א ו י ב ע ר ש ט ע ר
אויג	א ו י ג
אויגל	א ו י ג ל
אויגן	א ו י ג נ
אויגנלאך	א ו י ג נ ל א כ
אויוון	א ו י ו ו נ
אויך	א ו י כ
אויכעט	א ו י כ ע ט
אויס	א ו י ס
אויסבייטן	א ו י ס ב י י ט נ
אויסבעסערונגען	א ו י ס ב ע ס ע ר ו נ ג ע נ
אויסברעכן	א ו י ס ב ר ע כ נ
אויסברענגען	א ו י ס ב ר ע נ ג ע נ
אויסגיין	א ו י ס ג י י נ
אויסגליטשן	א ו י ס ג ל י ט ש נ
אויסגעבויגן	א ו י ס ג ע ב ו י ג נ
אויסגעבויט	א ו י ס ג ע ב ו י ט
אויסגעבעט	א ו י ס ג ע ב ע ט
אויסגעבעטע	א ו י ס ג ע ב ע ט ע
אויסגעברענט	א ו י ס ג ע ב ר ע נ ט
אויסגעגאנגען	א ו י ס ג ע ג א נ ג ע נ
אויסגעגאסן	א ו י ס ג ע ג א ס נ
אויסגעגלייכט	א ו י ס ג ע ג ל י י כ ט
אויסגעגעבן	א ו י ס ג ע ג ע ב נ
אויסגעגעבענע	א ו י ס ג ע ג ע ב ע נ ע
אויסגעגעבענער	א ו י ס ג ע ג ע ב ע נ ע ר
אויסגעדאכט	א ו י ס ג ע ד א כ ט
אויסגעדארטע	א ו י ס ג ע ד א ר ט ע
אויסגעדונגען	א ו י ס ג ע ד ו נ ג ע נ
אויסגעדרייט	א ו י ס ג ע ד ר י י ט
אויסגעדריקט	א ו י ס ג ע ד ר י ק ט
אויסגעהאלטן	א ו י ס ג ע ה א ל ט נ
אויסגעהארכט	א ו י ס ג ע ה א ר כ ט
אויסגעהערט	א ו י ס ג ע ה ע ר ט
אויסגעוואקסן	א ו י ס ג ע ו ו א ק ס נ
אויסגעוויזן	א ו י ס ג ע ו ו י ז נ
אויסגעוויינט	א ו י ס ג ע ו ו י י נ ט
אויסגעוויינטע	א ו י ס ג ע ו ו י י נ ט ע
אויסגעווישט	א ו י ס ג ע ו ו י ש ט
אויסגעזעהן	א ו י ס ג ע ז ע ה נ
אויסגעטון	א ו י ס ג ע ט ו נ
אויסגעטראטענע	א ו י ס ג ע ט ר א ט ע נ ע
אויסגעטראכט	א ו י ס ג ע ט ר א כ ט
אויסגעטרייסלט	א ו י ס ג ע ט ר י י ס ל ט
אויסגעטריקנט	א ו י ס ג ע ט ר י ק נ ט
אויסגעטרעטן	א ו י ס ג ע ט ר ע ט נ
אויסגעטרעטענע	א ו י ס ג ע ט ר ע ט ע נ ע
אויסגעלאזט	א ו י ס ג ע ל א ז ט
אויסגעלאשן	א ו י ס ג ע ל א ש נ
אויסגעלאשענע	א ו י ס ג ע ל א ש ע נ ע
אויסגעלייזט	א ו י ס ג ע ל י י ז ט
אויסגעליינט	א ו י ס ג ע ל י י נ ט
אויסגעליען	א ו י ס ג ע ל י ע נ
אויסגעלערנט	א ו י ס ג ע ל ע ר נ ט
אויסגעמאלט	א ו י ס ג ע מ א ל ט
אויסגעמישט	א ו י ס ג ע מ י ש ט
אויסגענייט	א ו י ס ג ע נ י י ט
אויסגעפאקט	א ו י ס ג ע פ א ק ט
אויסגעפירט	א ו י ס ג ע פ י ר ט
אויסגעצוואגן	א ו י ס ג ע צ ו ו א ג נ
אויסגעצויגן	א ו י ס ג ע צ ו י ג נ
אויסגעצויגענע	א ו י ס ג ע צ ו י ג ע נ ע
אויסגעצויגענער	א ו י ס ג ע צ ו י ג ע נ ע ר
אויסגעצייכנט	א ו י ס ג ע צ י י כ נ ט
אויסגעצירט	א ו י ס ג ע צ י ר ט
אויסגעקומען	א ו י ס ג ע ק ו מ ע נ
אויסגעקליבן	א ו י ס ג ע ק ל י ב נ
אויסגעקלעפט	א ו י ס ג ע ק ל ע פ ט
אויסגעקערט	א ו י ס ג ע ק ע ר ט
אויסגעקערעוועט	א ו י ס ג ע ק ע ר ע ו ו ע ט
אויסגעקראצט	א ו י ס ג ע ק ר א צ ט
אויסגעקרימטע	א ו י ס ג ע ק ר י מ ט ע
אויסגערופן	א ו י ס ג ע ר ו פ נ
אויסגעריבן	א ו י ס ג ע ר י ב נ
אויסגעריבענעם	א ו י ס ג ע ר י ב ע נ ע מ
אויסגעריסן	א ו י ס ג ע ר י ס נ
אויסגערעדט	א ו י ס ג ע ר ע ד ט
אויסגערעכנט	א ו י ס ג ע ר ע כ נ ט
אויסגעשאטן	א ו י ס ג ע ש א ט נ
אויסגעשטאנען	א ו י ס ג ע ש ט א נ ע נ
אויסגעשטעלט	א ו י ס ג ע ש ט ע ל ט
אויסגעשטעלטע	א ו י ס ג ע ש ט ע ל ט ע
אויסגעשטעקט	א ו י ס ג ע ש ט ע ק ט
אויסגעשטערנטער	א ו י ס ג ע ש ט ע ר נ ט ע ר
אויסגעשטרעקט	א ו י ס ג ע ש ט ר ע ק ט
אויסגעשטרעקטע	א ו י ס ג ע ש ט ר ע ק ט ע
אויסגעשלאגן	א ו י ס ג ע ש ל א ג נ
אויסגעשמירט	א ו י ס ג ע ש מ י ר ט
אויסגעשמירטער	א ו י ס ג ע ש מ י ר ט ע ר
אויסגעשניצט	א ו י ס ג ע ש נ י צ ט
אויסגעשפאנט	א ו י ס ג ע ש פ א נ ט
אויסגעשפיגן	א ו י ס ג ע ש פ י ג נ
אויסגעשפילטע	א ו י ס ג ע ש פ י ל ט ע
אויסגעשפרייט	א ו י ס ג ע ש פ ר י י ט
אויסגעשריי	א ו י ס ג ע ש ר י י
אויסדערציילן	א ו י ס ד ע ר צ י י ל נ
אויסדרייען	א ו י ס ד ר י י ע נ
אויסדריקן	א ו י ס ד ר י ק נ
אויסהאלטן	א ו י ס ה א ל ט נ
אויסהיטן	א ו י ס ה י ט נ
אויסהערן	א ו י ס ה ע ר נ
אויסהערנדיג	א ו י ס ה ע ר נ ד י ג
אויסווייזן	א ו י ס ו ו י י ז נ
אויסווייניג	א ו י ס ו ו י י נ י ג
אויסזען	א ו י ס ז ע נ
אויסטאן	א ו י ס ט א נ
אויסטייטשן	א ו י ס ט י י ט ש נ
אויסטרינקען	א ו י ס ט ר י נ ק ע נ
אויסכאפן	א ו י ס כ א פ נ
אויסלאנד	א ו י ס ל א נ ד
אויסלויפן	א ו י ס ל ו י פ נ
אויסלערנען	א ו י ס ל ע ר נ ע נ
אויסמאכן	א ו י ס מ א כ נ
אויסמיידן	א ו י ס מ י י ד נ
אויסמיידנדיג	א ו י ס מ י י ד נ ד י ג
אויסן	א ו י ס נ
אויסנארן	א ו י ס נ א ר נ
אויסנווייניג	א ו י ס נ ו ו י י נ י ג
אויסנעמען	א ו י ס נ ע מ ע נ
אויסער	א ו י ס ע ר
אויספארקויפט	א ו י ס פ א ר ק ו י פ ט
אויספארקויפן	א ו י ס פ א ר ק ו י פ נ
אויספירן	א ו י ס פ י ר נ
אויסצובעטלען	א ו י ס צ ו ב ע ט ל ע נ
אויסצוהאלטן	א ו י ס צ ו ה א ל ט נ
אויסצוטראכטן	א ו י ס צ ו ט ר א כ ט נ
אויסצולאזן	א ו י ס צ ו ל א ז נ
אויסצולערנען	א ו י ס צ ו ל ע ר נ ע נ
אויסצונוצן	א ו י ס צ ו נ ו צ נ
אויסצוניצן	א ו י ס צ ו נ י צ נ
אויסצוריידן	א ו י ס צ ו ר י י ד נ
אויסצורעדן	א ו י ס צ ו ר ע ד נ
אויסקומען	א ו י ס ק ו מ ע נ
אויסקוקן	א ו י ס ק ו ק נ
אויסקערן	א ו י ס ק ע ר נ
אויסרופן	א ו י ס ר ו פ נ
אויסריידן	א ו י ס ר י י ד נ
אויסרייסן	א ו י ס ר י י ס נ
אויסריכטן	א ו י ס ר י כ ט נ
אויסשטיין	א ו י ס ש ט י י נ
אויסשטייער	א ו י ס ש ט י י ע ר
אויסשטעכן	א ו י ס ש ט ע כ נ
אויסשטרעקנדיג	א ו י ס ש ט ר ע ק נ ד י ג
אויסשיסן	א ו י ס ש י ס נ
אויסשפייען	א ו י ס ש פ י י ע נ
אויען	א ו י ע נ
אויער	א ו י ע ר
אויערן	א ו י ע ר נ
אויף	א ו י ף
אויפגאב	א ו י פ ג א ב
אויפגעגאנגען	א ו י פ ג ע ג א נ ג ע נ
אויפגעגעסן	א ו י פ ג ע ג ע ס נ
אויפגעגעסענע	א ו י פ ג ע ג ע ס ע נ ע
אויפגעהאלטן	א ו י פ ג ע ה א ל ט נ
אויפגעהאנגען	א ו י פ ג ע ה א נ ג ע נ
אויפגעהויבן	א ו י פ ג ע ה ו י ב נ
אויפגעהערט	א ו י פ ג ע ה ע ר ט
אויפגעיוירענע	א ו י פ ג ע י ו י ר ע נ ע
אויפגעכאפט	א ו י פ ג ע כ א פ ט
אויפגעכאפטן	א ו י פ ג ע כ א פ ט נ
אויפגעלאפן	א ו י פ ג ע ל א פ נ
אויפגעלייגט	א ו י פ ג ע ל י י ג ט
אויפגעעפנט	א ו י פ ג ע ע פ נ ט
אויפגעפלאמט	א ו י פ ג ע פ ל א מ ט
אויפגעצויגן	א ו י פ ג ע צ ו י ג נ
אויפגעציטערט	א ו י פ ג ע צ י ט ע ר ט
אויפגעקומען	א ו י פ ג ע ק ו מ ע נ
אויפגעריכט	א ו י פ ג ע ר י כ ט
אויפגעריסענע	א ו י פ ג ע ר י ס ע נ ע
אויפגעשטאנען	א ו י פ ג ע ש ט א נ ע נ
אויפגעשטייגט	א ו י פ ג ע ש ט י י ג ט
אויפגעשטעלטע	א ו י פ ג ע ש ט ע ל ט ע
אויפגעשיינט	א ו י פ ג ע ש י י נ ט
אויפגעשפרונגען	א ו י פ ג ע ש פ ר ו נ ג ע נ
אויפדערנאכט	א ו י פ ד ע ר נ א כ ט
אויפהייבן	א ו י פ ה י י ב נ
אויפהענגען	א ו י פ ה ע נ ג ע נ
אויפהערן	א ו י פ ה ע ר נ
אויפכאפן	א ו י פ כ א פ נ
אויפן	א ו י פ נ
אויפס	א ו י פ ס
אויפעסן	א ו י פ ע ס נ
אויפצוהויבן	א ו י פ צ ו ה ו י ב נ
אויפצוזעצן	א ו י פ צ ו ז ע צ נ
אויפצושטייגן	א ו י פ צ ו ש ט י י ג נ
אויפצושטיין	א ו י פ צ ו ש ט י י נ
אויפקלערן	א ו י פ ק ל ע ר נ
אויפשטיין	א ו י פ ש ט י י נ
אוירינגלעך	א ו י ר י נ ג ל ע כ
אולעיילא	א ו ל ע י י ל א
אום	א ו מ
אומ־	א ו מ
אומאן	א ו מ א נ
אומברחמנות	א ו מ ב ר ח מ נ ו ת
אומגליק	א ו מ ג ל י ק
אומגליקלעכער	א ו מ ג ל י ק ל ע כ ע ר
אומגליקן	א ו מ ג ל י ק נ
אומגעדולדיגער	א ו מ ג ע ד ו ל ד י ג ע ר
אומגעהויער	א ו מ ג ע ה ו י ע ר
אומגעהויערס	א ו מ ג ע ה ו י ע ר ס
אומגעווארפן	א ו מ ג ע ו ו א ר פ נ
אומגעקוקט	א ו מ ג ע ק ו ק ט
אומגעריכט	א ו מ ג ע ר י כ ט
אומזיסט	א ו מ ז י ס ט
אומיסטנע	א ו מ י ס ט נ ע
אוממעגליך	א ו מ מ ע ג ל י כ
אומעטום	א ו מ ע ט ו מ
אומענער	א ו מ ע נ ע ר
אומצייטיגע	א ו מ צ י י ט י ג ע
אומקוקן	א ו מ ק ו ק נ
אומקערן	א ו מ ק ע ר נ
אומשולדיגן	א ו מ ש ו ל ד י ג נ
אומשולדיגער	א ו מ ש ו ל ד י ג ע ר
און	א ו נ
און־	א ו נ
אונז	א ו נ ז
אונזער	א ו נ ז ע ר
אונזערע	א ו נ ז ע ר ע
אונטן	א ו נ ט נ
אונטער	א ו נ ט ע ר
אונטערגיין	א ו נ ט ע ר ג י י נ
אונטערגעבן	א ו נ ט ע ר ג ע ב נ
אונטערגעגאנגען	א ו נ ט ע ר ג ע ג א נ ג ע נ
אונטערגעהאקט	א ו נ ט ע ר ג ע ה א ק ט
אונטערגעכאפט	א ו נ ט ע ר ג ע כ א פ ט
אונטערגעלייגט	א ו נ ט ע ר ג ע ל י י ג ט
אונטערגעצונדן	א ו נ ט ע ר ג ע צ ו נ ד נ
אונטערגעשטופט	א ו נ ט ע ר ג ע ש ט ו פ ט
אונטערגעשפרונגען	א ו נ ט ע ר ג ע ש פ ר ו נ ג ע נ
אונטערגעשריבן	א ו נ ט ע ר ג ע ש ר י ב נ
אונטערן	א ו נ ט ע ר נ
אונטערצוהייצן	א ו נ ט ע ר צ ו ה י י צ נ
אונטערקוקן	א ו נ ט ע ר ק ו ק נ
אונטערשטע	א ו נ ט ע ר ש ט ע
אונטערשיד	א ו נ ט ע ר ש י ד
אונטערשערן	א ו נ ט ע ר ש ע ר נ
אוניווערסיטעט	א ו נ י ו ו ע ר ס י ט ע ט
אופן	א ו פ נ
אוצר	א ו צ ר
אוצרות	א ו צ ר ו ת
אוקאז	א ו ק א ז
אור	א ו ר
אורח	א ו ר ח
אורחים	א ו ר ח י מ
אות	א ו ת
אותיות	א ו ת י ו ת
אותיות'לעך	א ו ת י ו ת ל ע כ
אז	א ז
אזא	א ז א
אזוי	א ז ו י
אזוינס	א ז ו י נ ס
אזוינע	א ז ו י נ ע
אזויפיל	א ז ו י פ י ל
אזעלכן	א ז ע ל כ נ
אזעלכס	א ז ע ל כ ס
אזעלכע	א ז ע ל כ ע
אזעלכעס	א ז ע ל כ ע ס
אזעלכער	א ז ע ל כ ע ר
אזש	א ז ש
אזשעניצעס	א ז ש ע נ י צ ע ס
אחדות	א ח ד ו ת
אחוץ	א ח ו צ
אחי	א ח י
אחינו־בני־ישראל	א ח י נ ו ב נ י י ש ר א ל
אט	א ט
אטלעסענע	א ט ל ע ס ע נ ע
אטלעסענעם	א ט ל ע ס ע נ ע מ
אטלעסענער	א ט ל ע ס ע נ ע ר
אטעם	א ט ע מ
אטשערעד	א ט ש ע ר ע ד
אטשערעדן	א ט ש ע ר ע ד נ
אי	א י
איא	א י א
איבער	א י ב ע ר
איבער'חזר'ן	א י ב ע ר ח ז ר נ
איבערבייטן	א י ב ע ר ב י י ט נ
איבערבלייבן	א י ב ע ר ב ל י י ב נ
איבערגע'חזר'ט	א י ב ע ר ג ע ח ז ר ט
איבערגעבליבן	א י ב ע ר ג ע ב ל י ב נ
איבערגעבן	א י ב ע ר ג ע ב נ
איבערגעבנדיג	א י ב ע ר ג ע ב נ ד י ג
איבערגעבראכן	א י ב ע ר ג ע ב ר א כ נ
איבערגעגאנגען	א י ב ע ר ג ע ג א נ ג ע נ
איבערגעגעבן	א י ב ע ר ג ע ג ע ב נ
איבערגעדעקט	א י ב ע ר ג ע ד ע ק ט
איבערגעדרייט	א י ב ע ר ג ע ד ר י י ט
איבערגעהאקט	א י ב ע ר ג ע ה א ק ט
איבערגעווינקט	א י ב ע ר ג ע ו ו י נ ק ט
איבערגעיאגט	א י ב ע ר ג ע י א ג ט
איבערגעלאזט	א י ב ע ר ג ע ל א ז ט
איבערגעלייגט	א י ב ע ר ג ע ל י י ג ט
איבערגעליינט	א י ב ע ר ג ע ל י י נ ט
איבערגענומען	א י ב ע ר ג ע נ ו מ ע נ
איבערגעפארן	א י ב ע ר ג ע פ א ר נ
איבערגעציילט	א י ב ע ר ג ע צ י י ל ט
איבערגעקוקט	א י ב ע ר ג ע ק ו ק ט
איבערגעקלונגען	א י ב ע ר ג ע ק ל ו נ ג ע נ
איבערגעקערט	א י ב ע ר ג ע ק ע ר ט
איבערגערעכנט	א י ב ע ר ג ע ר ע כ נ ט
איבערגעשראקן	א י ב ע ר ג ע ש ר א ק נ
איבערהויפט	א י ב ע ר ה ו י פ ט
איבעריג	א י ב ע ר י ג
איבעריגס	א י ב ע ר י ג ס
איבעריגע	א י ב ע ר י ג ע
איבעריקנס	א י ב ע ר י ק נ ס
איבערלאזן	א י ב ע ר ל א ז נ
איבערלויפן	א י ב ע ר ל ו י פ נ
איבערליינען	א י ב ע ר ל י י נ ע נ
איבערמאכן	א י ב ע ר מ א כ נ
איבערמארגן	א י ב ע ר מ א ר ג נ
איבערן	א י ב ע ר נ
איבערנעמען	א י ב ע ר נ ע מ ע נ
איבערפירער	א י ב ע ר פ י ר ע ר
איבערפירערס	א י ב ע ר פ י ר ע ר ס
איבערצולאזן	א י ב ע ר צ ו ל א ז נ
איבערצונעכטיגן	א י ב ע ר צ ו נ ע כ ט י ג נ
איבערצוציילן	א י ב ע ר צ ו צ י י ל נ
איבערצייגט	א י ב ע ר צ י י ג ט
איבערצייטיג	א י ב ע ר צ י י ט י ג
איבערציילן	א י ב ע ר צ י י ל נ
איבערציער	א י ב ע ר צ י ע ר
איבערקערן	א י ב ע ר ק ע ר נ
איבערשפארן	א י ב ע ר ש פ א ר נ
איבערשפיצטער	א י ב ע ר ש פ י צ ט ע ר
איבערשרייבן	א י ב ע ר ש ר י י ב נ
איד	א י ד
אידיש	א י ד י ש
אידישליך	א י ד י ש ל י כ
אידישן	א י ד י ש נ
אידישע	א י ד י ש ע
אידישער	א י ד י ש ע ר
אידישקייט	א י ד י ש ק י י ט
אידל	א י ד ל
אידלס	א י ד ל ס
אידן	א י ד נ
אידעלע	א י ד ע ל ע
אידעלעך	א י ד ע ל ע כ
אידענע	א י ד ע נ ע
איוב	א י ו ב
איוואן	א י ו ו א נ
איז	א י ז
איזן	א י ז נ
איטליכן	א י ט ל י כ נ
איטליכס	א י ט ל י כ ס
איטליכע	א י ט ל י כ ע
איטליכער	א י ט ל י כ ע ר
איטע	א י ט ע
איטעלע	א י ט ע ל ע
איטעלען	א י ט ע ל ע נ
איטען	א י ט ע נ
איי	א י י
איי־איי־איי	א י י א י י א י י
אייאיר	א י י א י ר
אייביג	א י י ב י ג
אייבערשטע	א י י ב ע ר ש ט ע
אייגל	א י י ג ל
אייגן	א י י ג נ
אייגנטליך	א י י ג נ ט ל י כ
אייגעלעך	א י י ג ע ל ע כ
אייגענע	א י י ג ע נ ע
אייגענעם	א י י ג ע נ ע מ
אייגענער	א י י ג ע נ ע ר
איידל	א י י ד ל
איידל־גלאטע	א י י ד ל ג ל א ט ע
איידעלן	א י י ד ע ל נ
איידעלע	א י י ד ע ל ע
איידעלער	א י י ד ע ל ע ר
איידעם	א י י ד ע מ
איידעמס	א י י ד ע מ ס
איידער	א י י ד ע ר
אייווארים	א י י ו ו א ר י מ
אייז	א י י ז
אייזהויך	א י י ז ה ו י כ
אייזן	א י י ז נ
אייזערן	א י י ז ע ר נ
אייך	א י י כ
אייל	א י י ל
איילט	א י י ל ט
איילן	א י י ל נ
איילעניש	א י י ל ע נ י ש
איין	א י י נ
איינבינדער	א י י נ ב י נ ד ע ר
איינגייער	א י י נ ג י י ע ר
איינגייערין	א י י נ ג י י ע ר י נ
איינגעבויגענע	א י י נ ג ע ב ו י ג ע נ ע
איינגעבויגענער	א י י נ ג ע ב ו י ג ע נ ע ר
איינגעבעטן	א י י נ ג ע ב ע ט נ
איינגעבראכן	א י י נ ג ע ב ר א כ נ
איינגעגאנגען	א י י נ ג ע ג א נ ג ע נ
איינגעגעסענע	א י י נ ג ע ג ע ס ע נ ע
איינגעדארטס	א י י נ ג ע ד א ר ט ס
איינגעדארטע	א י י נ ג ע ד א ר ט ע
איינגעדרעמלט	א י י נ ג ע ד ר ע מ ל ט
איינגעהאלטענער	א י י נ ג ע ה א ל ט ע נ ע ר
איינגעהאנדלט	א י י נ ג ע ה א נ ד ל ט
איינגעהארכט	א י י נ ג ע ה א ר כ ט
איינגעהילט	א י י נ ג ע ה י ל ט
איינגעוואוינט	א י י נ ג ע ו ו א ו י נ ט
איינגעוויקלט	א י י נ ג ע ו ו י ק ל ט
איינגעזונקען	א י י נ ג ע ז ו נ ק ע נ
איינגעטוליעט	א י י נ ג ע ט ו ל י ע ט
איינגעטונקט	א י י נ ג ע ט ו נ ק ט
איינגעטונקען	א י י נ ג ע ט ו נ ק ע נ
איינגעטיילט	א י י נ ג ע ט י י ל ט
איינגעלאדן	א י י נ ג ע ל א ד נ
איינגעלויף	א י י נ ג ע ל ו י ף
איינגעלייגט	א י י נ ג ע ל י י ג ט
איינגעמאכטס	א י י נ ג ע מ א כ ט ס
איינגעמאכטסן	א י י נ ג ע מ א כ ט ס נ
איינגענומען	א י י נ ג ע נ ו מ ע נ
איינגענעם	א י י נ ג ע נ ע מ
איינגעפאלן	א י י נ ג ע פ א ל נ
איינגעפאלענע	א י י נ ג ע פ א ל ע נ ע
איינגעפאסט	א י י נ ג ע פ א ס ט
איינגעפירט	א י י נ ג ע פ י ר ט
איינגעפלאכטן	א י י נ ג ע פ ל א כ ט נ
איינגעפלאנצט	א י י נ ג ע פ ל א נ צ ט
איינגעפרוירן	א י י נ ג ע פ ר ו י ר נ
איינגעפרוירענע	א י י נ ג ע פ ר ו י ר ע נ ע
איינגעקנייטשטן	א י י נ ג ע ק נ י י ט ש ט נ
איינגעקנייטשטס	א י י נ ג ע ק נ י י ט ש ט ס
איינגעקנייטשטער	א י י נ ג ע ק נ י י ט ש ט ע ר
איינגערוימט	א י י נ ג ע ר ו י מ ט
איינגעשטאנען	א י י נ ג ע ש ט א נ ע נ
איינגעשטימט	א י י נ ג ע ש ט י מ ט
איינגעשלאפן	א י י נ ג ע ש ל א פ נ
איינגעשפאנט	א י י נ ג ע ש פ א נ ט
איינגעשפארט	א י י נ ג ע ש פ א ר ט
איינגעשרומפענע	א י י נ ג ע ש ר ו מ פ ע נ ע
איינגעשריבן	א י י נ ג ע ש ר י ב נ
איינדרוק	א י י נ ד ר ו ק
איינהאלטן	א י י נ ה א ל ט נ
איינהייצן	א י י נ ה י י צ נ
איינוואשן	א י י נ ו ו א ש נ
איינזאם	א י י נ ז א מ
איינזאמע	א י י נ ז א מ ע
איינזאמער	א י י נ ז א מ ע ר
איינזיצן	א י י נ ז י צ נ
אייניגע	א י י נ י ג ע
אייניקל	א י י נ י ק ל
אייניקלעך	א י י נ י ק ל ע כ
איינמאל	א י י נ מ א ל
אייננעמען	א י י נ נ ע מ ע נ
איינס	א י י נ ס
איינע	א י י נ ע
איינעם	א י י נ ע מ
איינער	א י י נ ע ר
איינפאלן	א י י נ פ א ל נ
איינצוהאנדלען	א י י נ צ ו ה א נ ד ל ע נ
איינצושלינגען	א י י נ צ ו ש ל י נ ג ע נ
איינציגווייז	א י י נ צ י ג ו ו י י ז
איינציגן	א י י נ צ י ג נ
איינציגע	א י י נ צ י ג ע
איינציגער	א י י נ צ י ג ע ר
איינצלנע	א י י נ צ ל נ ע
איינשטודירן	א י י נ ש ט ו ד י ר נ
איינשטיין	א י י נ ש ט י י נ
איינשטעלן	א י י נ ש ט ע ל נ
איינשלאפן	א י י נ ש ל א פ נ
איינשפאנען	א י י נ ש פ א נ ע נ
איינשרייבן	א י י נ ש ר י י ב נ
אייען	א י י ע נ
אייער	א י י ע ר
אייער־בייגל	א י י ע ר ב י י ג ל
אייער־קיכלעך	א י י ע ר ק י כ ל ע כ
אייער־קנאקן	א י י ע ר ק נ א ק נ
אייערן	א י י ע ר נ
אייערנעכטיג	א י י ע ר נ ע כ ט י ג
אייערס	א י י ע ר ס
אייערע	א י י ע ר ע
אייערער	א י י ע ר ע ר
אייצים	א י י צ י מ
אייראפע	א י י ר א פ ע
אייראפעישע	א י י ר א פ ע י ש ע
איישישאק	א י י ש י ש א ק
איך	א י כ
אים	א י מ
אימה	א י מ ה
אימהדיגע	א י מ ה ד י ג ע
אימעצן	א י מ ע צ נ
אימער	א י מ ע ר
אימשטאנד	א י מ ש ט א נ ד
אין	א י נ
אינאיינעם	א י נ א י י נ ע מ
אינגאנצן	א י נ ג א נ צ נ
אינגל	א י נ ג ל
אינגלעך	א י נ ג ל ע כ
אינגסטע	א י נ ג ס ט ע
אינגסטער	א י נ ג ס ט ע ר
אינגעלע	א י נ ג ע ל ע
אינגעלעס	א י נ ג ע ל ע ס
אינגערע	א י נ ג ע ר ע
אינגערשע	א י נ ג ע ר ש ע
אינדזלען	א י נ ד ז ל ע נ
אינדיטשקע	א י נ ד י ט ש ק ע
אינדיטשקעס	א י נ ד י ט ש ק ע ס
אינדיקעס	א י נ ד י ק ע ס
אינדערהיים	א י נ ד ע ר ה י י מ
אינדערוואכן	א י נ ד ע ר ו ו א כ נ
אינדערפרי	א י נ ד ע ר פ ר י
אינדרויסן	א י נ ד ר ו י ס נ
אינהאלט	א י נ ה א ל ט
אינזינען	א י נ ז י נ ע נ
אינטערעסאנטע	א י נ ט ע ר ע ס א נ ט ע
אינטערעסירט	א י נ ט ע ר ע ס י ר ט
אינמיטן	א י נ מ י ט נ
אינסטיטוציעס	א י נ ס ט י ט ו צ י ע ס
אינסינואציעס	א י נ ס י נ ו א צ י ע ס
אינעווייניג	א י נ ע ו ו י י נ י ג
אינעם	א י נ ע מ
איעדער	א י ע ד ע ר
איצט	א י צ ט
איצטיגס	א י צ ט י ג ס
איצטער	א י צ ט ע ר
איר	א י ר
אירס	א י ר ס
אירע	א י ר ע
אישה	א י ש ה
אך	א כ
אכט	א כ ט
אכט־און־דרייסיג	א כ ט א ו נ ד ר י י ס י ג
אכטונג	א כ ט ו נ ג
אכילה	א כ י ל ה
אכסניא	א כ ס נ י א
אכסניה	א כ ס נ י ה
אכציג	א כ צ י ג
אכצן	א כ צ נ
אל	א ל
אל־	א ל
אלאבאסטער	א ל א ב א ס ט ע ר
אלגעבריניג	א ל ג ע ב ר י נ י ג
אלגעברע	א ל ג ע ב ר ע
אלט	א ל ט
אלט־באקאנטן	א ל ט ב א ק א נ ט נ
אלט־גרויער	א ל ט ג ר ו י ע ר
אלטמאדישן	א ל ט מ א ד י ש נ
אלטן	א ל ט נ
אלטע	א ל ט ע
אלטער	א ל ט ע ר
אלטערטום־פארשער	א ל ט ע ר ט ו מ פ א ר ש ע ר
אליה	א ל י ה
אליהן	א ל י ה נ
אליהס	א ל י ה ס
אליין	א ל י י נ
אלייען	א ל י י ע נ
אלמנה	א ל מ נ ה
אלס	א ל ס
אלע	א ל ע
אלעם	א ל ע מ
אלעמאל	א ל ע מ א ל
אלעמען	א ל ע מ ע נ
אלעמענס	א ל ע מ ע נ ס
אלעס	א ל ע ס
אלערליי	א ל ע ר ל י י
אלף	א ל ף
אלף־בית	א ל ף ב י ת
אלץ	א ל צ
אלצדינג	א ל צ ד י נ ג
אלקער	א ל ק ע ר
אם	א מ
אם־ירצה־השם	א מ י ר צ ה ה ש מ
אם־כן	א מ כ נ
אמאל	א מ א ל
אמאליגע	א מ א ל י ג ע
אמבאסאדאר	א מ ב א ס א ד א ר
אמן	א מ נ
אמער	א מ ע ר
אמעריקאניזירט	א מ ע ר י ק א נ י ז י ר ט
אמעריקאניזירן	א מ ע ר י ק א נ י ז י ר נ
אמעריקאניזם	א מ ע ר י ק א נ י ז מ
אמעריקאנער	א מ ע ר י ק א נ ע ר
אמעריקע	א מ ע ר י ק ע
אמר	א מ ר
אמת	א מ ת
אמת'ן	א מ ת נ
אמת'ע	א מ ת ע
אמת'ער	א מ ת ע ר
אן	א נ
אנבאטן	א נ ב א ט נ
אנבאלאנגט	א נ ב א ל א נ ג ט
אנבויגן	א נ ב ו י ג נ
אנבייסן	א נ ב י י ס נ
אנגיין	א נ ג י י נ
אנגיסן	א נ ג י ס נ
אנגעבויגן	א נ ג ע ב ו י ג נ
אנגעבוכעט	א נ ג ע ב ו כ ע ט
אנגעבונדן	א נ ג ע ב ו נ ד נ
אנגעבלאזן	א נ ג ע ב ל א ז נ
אנגעגאנגען	א נ ג ע ג א נ ג ע נ
אנגעגאסן	א נ ג ע ג א ס נ
אנגעגארטלט	א נ ג ע ג א ר ט ל ט
אנגעגעסן	א נ ג ע ג ע ס נ
אנגעהארעוועטע	א נ ג ע ה א ר ע ו ו ע ט ע
אנגעהויבן	א נ ג ע ה ו י ב נ
אנגעוואוירן	א נ ג ע ו ו א ו י ר נ
אנגעוויזן	א נ ג ע ו ו י ז נ
אנגעזאגט	א נ ג ע ז א ג ט
אנגעזויגן	א נ ג ע ז ו י ג נ
אנגעזויפן	א נ ג ע ז ו י פ נ
אנגעזעצט	א נ ג ע ז ע צ ט
אנגעטון	א נ ג ע ט ו נ
אנגעטראפן	א נ ג ע ט ר א פ נ
אנגעטרונקען	א נ ג ע ט ר ו נ ק ע נ
אנגעכאפט	א נ ג ע כ א פ ט
אנגעלייגט	א נ ג ע ל י י ג ט
אנגעלענט	א נ ג ע ל ע נ ט
אנגעמאכט	א נ ג ע מ א כ ט
אנגעמאסטן	א נ ג ע מ א ס ט נ
אנגעמוטשעט	א נ ג ע מ ו ט ש ע ט
אנגענומען	א נ ג ע נ ו מ ע נ
אנגעפאלן	א נ ג ע פ א ל נ
אנגעפילט	א נ ג ע פ י ל ט
אנגעפילטער	א נ ג ע פ י ל ט ע ר
אנגעפרעסן	א נ ג ע פ ר ע ס נ
אנגעצויגן	א נ ג ע צ ו י ג נ
אנגעצונדן	א נ ג ע צ ו נ ד נ
אנגעקארמעט	א נ ג ע ק א ר מ ע ט
אנגעקומען	א נ ג ע ק ו מ ע נ
אנגעקומענע	א נ ג ע ק ו מ ע נ ע
אנגעקלאפט	א נ ג ע ק ל א פ ט
אנגעקליבן	א נ ג ע ק ל י ב נ
אנגעקלעפט	א נ ג ע ק ל ע פ ט
אנגערופן	א נ ג ע ר ו פ נ
אנגערוקט	א נ ג ע ר ו ק ט
אנגערעכנט	א נ ג ע ר ע כ נ ט
אנגעשאטן	א נ ג ע ש א ט נ
אנגעשוואלענע	א נ ג ע ש ו ו א ל ע נ ע
אנגעשטעלט	א נ ג ע ש ט ע ל ט
אנגעשלאגן	א נ ג ע ש ל א ג נ
אנגעשריבן	א נ ג ע ש ר י ב נ
אנגעשריבענע	א נ ג ע ש ר י ב ע נ ע
אנגעשריבענעם	א נ ג ע ש ר י ב ע נ ע מ
אנדער	א נ ד ע ר
אנדערטהאלבן	א נ ד ע ר ט ה א ל ב נ
אנדערן	א נ ד ע ר נ
אנדערע	א נ ד ע ר ע
אנדערער	א נ ד ע ר ע ר
אנדערש	א נ ד ע ר ש
אנהויב	א נ ה ו י ב
אנהויבן	א נ ה ו י ב נ
אנהייב	א נ ה י י ב
אנהענגען	א נ ה ע נ ג ע נ
אנו	א נ ו
אנווארעמען	א נ ו ו א ר ע מ ע נ
אנווייזונגען	א נ ו ו י י ז ו נ ג ע נ
אנווייזן	א נ ו ו י י ז נ
אנווינטשעווען	א נ ו ו י נ ט ש ע ו ו ע נ
אנומלט	א נ ו מ ל ט
אנומלטן	א נ ו מ ל ט נ
אנזאגן	א נ ז א ג נ
אנזעהענדיגן	א נ ז ע ה ע נ ד י ג נ
אנזען	א נ ז ע נ
אנטאן	א נ ט א נ
אנטגאנגען	א נ ט ג א נ ג ע נ
אנטיג	א נ ט י ג
אנטיג־מארע	א נ ט י ג מ א ר ע
אנטיסעמיט	א נ ט י ס ע מ י ט
אנטיקלעך	א נ ט י ק ל ע כ
אנטיקן	א נ ט י ק נ
אנטלאפן	א נ ט ל א פ נ
אנטלויף	א נ ט ל ו י ף
אנטלויפט	א נ ט ל ו י פ ט
אנטלויפן	א נ ט ל ו י פ נ
אנטעק	א נ ט ע ק
אנטעקן	א נ ט ע ק נ
אנטקעגן	א נ ט ק ע ג נ
אנטקעגנגעלאפן	א נ ט ק ע ג נ ג ע ל א פ נ
אנטראגן	א נ ט ר א ג נ
אנטשולדיגט	א נ ט ש ו ל ד י ג ט
אנטשלאפן	א נ ט ש ל א פ נ
אני־הקטן	א נ י ה ק ט נ
אנידער	א נ י ד ע ר
אנידערגעלייגט	א נ י ד ע ר ג ע ל י י ג ט
אנידערגעשטעלט	א נ י ד ע ר ג ע ש ט ע ל ט
אנידערלייגן	א נ י ד ע ר ל י י ג נ
אניט	א נ י ט
אניצעס	א נ י צ ע ס
אנלייגן	א נ ל י י ג נ
אנלענען	א נ ל ע נ ע נ
אנלענער	א נ ל ע נ ע ר
אננעמען	א נ נ ע מ ע נ
אננעמענדיג	א נ נ ע מ ע נ ד י ג
אנפירער	א נ פ י ר ע ר
אנצוזאגן	א נ צ ו ז א ג נ
אנצולויפן	א נ צ ו ל ו י פ נ
אנצוצינדן	א נ צ ו צ י נ ד נ
אנצוקוקן	א נ צ ו ק ו ק נ
אנציינערדיגן	א נ צ י י נ ע ר ד י ג נ
אנצינדן	א נ צ י נ ד נ
אנציען	א נ צ י ע נ
אנקומען	א נ ק ו מ ע נ
אנקומענדיג	א נ ק ו מ ע נ ד י ג
אנקומעניש	א נ ק ו מ ע נ י ש
אנקוקן	א נ ק ו ק נ
אנקוקנדיג	א נ ק ו ק נ ד י ג
אנרופן	א נ ר ו פ נ
אנרירן	א נ ר י ר נ
אנשטאט	א נ ש ט א ט
אנשטופן	א נ ש ט ו פ נ
אנשיקעניש	א נ ש י ק ע נ י ש
אנשמעקן	א נ ש מ ע ק נ
אנשפיגלען	א נ ש פ י ג ל ע נ
אנשפילן	א נ ש פ י ל נ
אנשרייבן	א נ ש ר י י ב נ
אסאך	א ס א כ
אסור	א ס ו ר
אסור־לדבר	א ס ו ר ל ד ב ר
אסטרע	א ס ט ר ע
אפ	א פ
אפבייטן	א פ ב י י ט נ
אפבייסן	א פ ב י י ס נ
אפבעטן	א פ ב ע ט נ
אפגעבאקן	א פ ג ע ב א ק נ
אפגעבליט	א פ ג ע ב ל י ט
אפגעבן	א פ ג ע ב נ
אפגעבענטשט	א פ ג ע ב ע נ ט ש ט
אפגעבראכט	א פ ג ע ב ר א כ ט
אפגעבריט	א פ ג ע ב ר י ט
אפגעברענט	א פ ג ע ב ר ע נ ט
אפגעגאלט	א פ ג ע ג א ל ט
אפגעגאנגען	א פ ג ע ג א נ ג ע נ
אפגעגלאנצט	א פ ג ע ג ל א נ צ ט
אפגעגעבן	א פ ג ע ג ע ב נ
אפגעגעסן	א פ ג ע ג ע ס נ
אפגעגריזשעטע	א פ ג ע ג ר י ז ש ע ט ע
אפגעדעקטער	א פ ג ע ד ע ק ט ע ר
אפגעהאלטן	א פ ג ע ה א ל ט נ
אפגעהאנדלט	א פ ג ע ה א נ ד ל ט
אפגעהאקט	א פ ג ע ה א ק ט
אפגעהאקטע	א פ ג ע ה א ק ט ע
אפגעהיטן	א פ ג ע ה י ט נ
אפגעווארפן	א פ ג ע ו ו א ר פ נ
אפגעוויינען	א פ ג ע ו ו י י נ ע נ
אפגעזאגט	א פ ג ע ז א ג ט
אפגעזונדערט	א פ ג ע ז ו נ ד ע ר ט
אפגעזיפצט	א פ ג ע ז י פ צ ט
אפגעטאקטע	א פ ג ע ט א ק ט ע
אפגעטון	א פ ג ע ט ו נ
אפגעטיילט	א פ ג ע ט י י ל ט
אפגעטראטן	א פ ג ע ט ר א ט נ
אפגעלאזט	א פ ג ע ל א ז ט
אפגעלייגט	א פ ג ע ל י י ג ט
אפגעלייגטע	א פ ג ע ל י י ג ט ע
אפגעלעבט	א פ ג ע ל ע ב ט
אפגעלעבטע	א פ ג ע ל ע ב ט ע
אפגעמאכט	א פ ג ע מ א כ ט
אפגעמאסטן	א פ ג ע מ א ס ט נ
אפגענארט	א פ ג ע נ א ר ט
אפגעענטפערט	א פ ג ע ע נ ט פ ע ר ט
אפגעפאלענע	א פ ג ע פ א ל ע נ ע
אפגעפרוירן	א פ ג ע פ ר ו י ר נ
אפגעציילטע	א פ ג ע צ י י ל ט ע
אפגעקאכט	א פ ג ע ק א כ ט
אפגעקאסט	א פ ג ע ק א ס ט
אפגעקויפט	א פ ג ע ק ו י פ ט
אפגעקומען	א פ ג ע ק ו מ ע נ
אפגעקומענער	א פ ג ע ק ו מ ע נ ע ר
אפגעקלאפט	א פ ג ע ק ל א פ ט
אפגעקלונגען	א פ ג ע ק ל ו נ ג ע נ
אפגעקנאקט	א פ ג ע ק נ א ק ט
אפגעקערט	א פ ג ע ק ע ר ט
אפגעקערעוועט	א פ ג ע ק ע ר ע ו ו ע ט
אפגעקרייט	א פ ג ע ק ר י י ט
אפגעקרעכצט	א פ ג ע ק ר ע כ צ ט
אפגערוקט	א פ ג ע ר ו ק ט
אפגעריבענע	א פ ג ע ר י ב ע נ ע
אפגעריכט	א פ ג ע ר י כ ט
אפגעריסן	א פ ג ע ר י ס נ
אפגעריסענע	א פ ג ע ר י ס ע נ ע
אפגערעדט	א פ ג ע ר ע ד ט
אפגעשאלט	א פ ג ע ש א ל ט
אפגעשארן	א פ ג ע ש א ר נ
אפגעשטאט	א פ ג ע ש ט א ט
אפגעשטופט	א פ ג ע ש ט ו פ ט
אפגעשטעלט	א פ ג ע ש ט ע ל ט
אפגעשטעקט	א פ ג ע ש ט ע ק ט
אפגעשלאגן	א פ ג ע ש ל א ג נ
אפגעשליסענע	א פ ג ע ש ל י ס ע נ ע
אפגעשפילט	א פ ג ע ש פ י ל ט
אפגעשריבן	א פ ג ע ש ר י ב נ
אפדאווענען	א פ ד א ו ו ע נ ע נ
אפדארן	א פ ד א ר נ
אפדרייען	א פ ד ר י י ע נ
אפהאנדלען	א פ ה א נ ד ל ע נ
אפווארטן	א פ ו ו א ר ט נ
אפוועגן	א פ ו ו ע ג נ
אפותיקי	א פ ו ת י ק י
אפזאגן	א פ ז א ג נ
אפט	א פ ט
אפטון	א פ ט ו נ
אפטיילן	א פ ט י י ל נ
אפטייק	א פ ט י י ק
אפטמאל	א פ ט מ א ל
אפטרייסלען	א פ ט ר י י ס ל ע נ
אפטרעטן	א פ ט ר ע ט נ
אפטרענען	א פ ט ר ע נ ע נ
אפילו	א פ י ל ו
אפיקורס	א פ י ק ו ר ס
אפיקורסים	א פ י ק ו ר ס י מ
אפלאדיסמענטן	א פ ל א ד י ס מ ע נ ט נ
אפלאדירן	א פ ל א ד י ר נ
אפלאזן	א פ ל א ז נ
אפלויבן	א פ ל ו י ב נ
אפלויז	א פ ל ו י ז
אפלעקן	א פ ל ע ק נ
אפן	א פ נ
אפנים	א פ נ י מ
אפנעמען	א פ נ ע מ ע נ
אפענע	א פ ע נ ע
אפענעם	א פ ע נ ע מ
אפעראציעס	א פ ע ר א צ י ע ס
אפפאלן	א פ פ א ל נ
אפפאסטן	א פ פ א ס ט נ
אפפירגעלט	א פ פ י ר ג ע ל ט
אפפירן	א פ פ י ר נ
אפצאלן	א פ צ א ל נ
אפצאסן	א פ צ א ס נ
אפצודאנקען	א פ צ ו ד א נ ק ע נ
אפצוטרעטן	א פ צ ו ט ר ע ט נ
אפצולייגן	א פ צ ו ל י י ג נ
אפצוקאכן	א פ צ ו ק א כ נ
אפצושינדן	א פ צ ו ש י נ ד נ
אפצושניידן	א פ צ ו ש נ י י ד נ
אפרייניגן	א פ ר י י נ י ג נ
אפרייסן	א פ ר י י ס נ
אפריכטן	א פ ר י כ ט נ
אפרעכענען	א פ ר ע כ ע נ ע נ
אפשווייגן	א פ ש ו ו י י ג נ
אפשטעלן	א פ ש ט ע ל נ
אפשטעקן	א פ ש ט ע ק נ
אפשפילן	א פ ש פ י ל נ
אפשר	א פ ש ר
אצינד	א צ י נ ד
אקוראט	א ק ו ר א ט
אקושאר	א ק ו ש א ר
אקט	א ק ט
אקטיאר	א ק ט י א ר
אקטיארן	א ק ט י א ר נ
אקטן	א ק ט נ
אקס	א ק ס
אקסל	א ק ס ל
אקסלען	א ק ס ל ע נ
אקסן	א ק ס נ
אקסנשריט	א ק ס נ ש ר י ט
אקעגן	א ק ע ג נ
אקעוויט	א ק ע ו ו י ט
אקציע	א ק צ י ע
אקצענט	א ק צ ע נ ט
אראפ	א ר א פ
אראפברענגען	א ר א פ ב ר ע נ ג ע נ
אראפגיין	א ר א פ ג י י נ
אראפגעבויגן	א ר א פ ג ע ב ו י ג נ
אראפגעבראכט	א ר א פ ג ע ב ר א כ ט
אראפגעגאסן	א ר א פ ג ע ג א ס נ
אראפגעהאנגען	א ר א פ ג ע ה א נ ג ע נ
אראפגעווארפן	א ר א פ ג ע ו ו א ר פ נ
אראפגעלאזט	א ר א פ ג ע ל א ז ט
אראפגעלאזטן	א ר א פ ג ע ל א ז ט נ
אראפגעלאזטע	א ר א פ ג ע ל א ז ט ע
אראפגעלאזענעם	א ר א פ ג ע ל א ז ע נ ע מ
אראפגעלויכטן	א ר א פ ג ע ל ו י כ ט נ
אראפגענומען	א ר א פ ג ע נ ו מ ע נ
אראפגעפאלן	א ר א פ ג ע פ א ל נ
אראפגעפונקלט	א ר א פ ג ע פ ו נ ק ל ט
אראפגעפטרט	א ר א פ ג ע פ ט ר ט
אראפגעקוקט	א ר א פ ג ע ק ו ק ט
אראפגעריסן	א ר א פ ג ע ר י ס נ
אראפגעשליידערט	א ר א פ ג ע ש ל י י ד ע ר ט
אראפווארפן	א ר א פ ו ו א ר פ נ
אראפפאלן	א ר א פ פ א ל נ
אראפפארן	א ר א פ פ א ר נ
ארבוז	א ר ב ו ז
ארבוזעס	א ר ב ו ז ע ס
ארבל	א ר ב ל
ארבע־כנפותל	א ר ב ע כ נ פ ו ת ל
ארבעט	א ר ב ע ט
ארבעטן	א ר ב ע ט נ
ארבעטער	א ר ב ע ט ע ר
ארבעס	א ר ב ע ס
ארגיע	א ר ג י ע
ארדענונג	א ר ד ע נ ו נ ג
ארויס	א ר ו י ס
ארויסבאוויזן	א ר ו י ס ב א ו ו י ז נ
ארויסבאווייזן	א ר ו י ס ב א ו ו י י ז נ
ארויסבאקומען	א ר ו י ס ב א ק ו מ ע נ
ארויסגייענדיג	א ר ו י ס ג י י ע נ ד י ג
ארויסגייער	א ר ו י ס ג י י ע ר
ארויסגע'גנב'עט	א ר ו י ס ג ע ג נ ב ע ט
ארויסגעבן	א ר ו י ס ג ע ב נ
ארויסגעגאנגען	א ר ו י ס ג ע ג א נ ג ע נ
ארויסגעגאסן	א ר ו י ס ג ע ג א ס נ
ארויסגעדרינגט	א ר ו י ס ג ע ד ר י נ ג ט
ארויסגעדרענגט	א ר ו י ס ג ע ד ר ע נ ג ט
ארויסגעווארפן	א ר ו י ס ג ע ו ו א ר פ נ
ארויסגעוויזן	א ר ו י ס ג ע ו ו י ז נ
ארויסגעטריבן	א ר ו י ס ג ע ט ר י ב נ
ארויסגעכאפט	א ר ו י ס ג ע כ א פ ט
ארויסגעלאזט	א ר ו י ס ג ע ל א ז ט
ארויסגעלאפן	א ר ו י ס ג ע ל א פ נ
ארויסגעלקחנט	א ר ו י ס ג ע ל ק ח נ ט
ארויסגעמשלחט	א ר ו י ס ג ע מ ש ל ח ט
ארויסגענומען	א ר ו י ס ג ע נ ו מ ע נ
ארויסגעפאלן	א ר ו י ס ג ע פ א ל נ
ארויסגעצויגן	א ר ו י ס ג ע צ ו י ג נ
ארויסגעקוקט	א ר ו י ס ג ע ק ו ק ט
ארויסגעקושט	א ר ו י ס ג ע ק ו ש ט
ארויסגעקייכט	א ר ו י ס ג ע ק י י כ ט
ארויסגעקראכן	א ר ו י ס ג ע ק ר א כ נ
ארויסגעקריגן	א ר ו י ס ג ע ק ר י ג נ
ארויסגעראטעוועט	א ר ו י ס ג ע ר א ט ע ו ו ע ט
ארויסגעריסן	א ר ו י ס ג ע ר י ס נ
ארויסגעשטארט	א ר ו י ס ג ע ש ט א ר ט
ארויסגעשטופט	א ר ו י ס ג ע ש ט ו פ ט
ארויסגעשטעלט	א ר ו י ס ג ע ש ט ע ל ט
ארויסגעשיינט	א ר ו י ס ג ע ש י י נ ט
ארויסגעשפראצט	א ר ו י ס ג ע ש פ ר א צ ט
ארויסווארפן	א ר ו י ס ו ו א ר פ נ
ארויסווייזן	א ר ו י ס ו ו י י ז נ
ארויסזאגן	א ר ו י ס ז א ג נ
ארויסטראגן	א ר ו י ס ט ר א ג נ
ארויסטרייבן	א ר ו י ס ט ר י י ב נ
ארויסלאזן	א ר ו י ס ל א ז נ
ארויסלויפנדיג	א ר ו י ס ל ו י פ נ ד י ג
ארויסנעמען	א ר ו י ס נ ע מ ע נ
ארויסצואווארפן	א ר ו י ס צ ו א ו ו א ר פ נ
ארויסצולאזן	א ר ו י ס צ ו ל א ז נ
ארויסצונעמען	א ר ו י ס צ ו נ ע מ ע נ
ארויסצורעדן	א ר ו י ס צ ו ר ע ד נ
ארויסקומען	א ר ו י ס ק ו מ ע נ
ארויסקומענדיג	א ר ו י ס ק ו מ ע נ ד י ג
ארויסקרייען	א ר ו י ס ק ר י י ע נ
ארויסרייסן	א ר ו י ס ר י י ס נ
ארויסשטעקנדיג	א ר ו י ס ש ט ע ק נ ד י ג
ארויף	א ר ו י ף
ארויף־ארויף	א ר ו י ף א ר ו י ף
ארויפגעבראכט	א ר ו י פ ג ע ב ר א כ ט
ארויפגעכאפט	א ר ו י פ ג ע כ א פ ט
ארויפגעלייגט	א ר ו י פ ג ע ל י י ג ט
ארויפלייגן	א ר ו י פ ל י י ג נ
ארויפרוקנדיג	א ר ו י פ ר ו ק נ ד י ג
ארום	א ר ו מ
ארומגיין	א ר ו מ ג י י נ
ארומגעגארטלט	א ר ו מ ג ע ג א ר ט ל ט
ארומגעטאנצט	א ר ו מ ג ע ט א נ צ ט
ארומגעכאפט	א ר ו מ ג ע כ א פ ט
ארומגענומען	א ר ו מ ג ע נ ו מ ע נ
ארומגעצאלט	א ר ו מ ג ע צ א ל ט
ארומגעצוימט	א ר ו מ ג ע צ ו י מ ט
ארומגעקוקט	א ר ו מ ג ע ק ו ק ט
ארומגעשטעלט	א ר ו מ ג ע ש ט ע ל ט
ארומגעשטעקט	א ר ו מ ג ע ש ט ע ק ט
ארומגעשפרונגען	א ר ו מ ג ע ש פ ר ו נ ג ע נ
ארומוואלגערן	א ר ו מ ו ו א ל ג ע ר נ
ארומיגע	א ר ו מ י ג ע
ארומקוקן	א ר ו מ ק ו ק נ
ארון־קודש	א ר ו נ ק ו ד ש
ארונטער	א ר ו נ ט ע ר
ארונטערגעגאנגען	א ר ו נ ט ע ר ג ע ג א נ ג ע נ
ארונטערגעלייגט	א ר ו נ ט ע ר ג ע ל י י ג ט
ארונטערגענומען	א ר ו נ ט ע ר ג ע נ ו מ ע נ
ארונטערגערוקט	א ר ו נ ט ע ר ג ע ר ו ק ט
ארט	א ר ט
ארטיסט	א ר ט י ס ט
ארטיסטן	א ר ט י ס ט נ
ארטיקל	א ר ט י ק ל
אריבער	א ר י ב ע ר
אריבערגע'גנב'עט	א ר י ב ע ר ג ע ג נ ב ע ט
אריבערגעוואונקען	א ר י ב ע ר ג ע ו ו א ו נ ק ע נ
אריבערגעשפאנט	א ר י ב ע ר ג ע ש פ א נ ט
אריבערטראגן	א ר י ב ע ר ט ר א ג נ
אריבערפירן	א ר י ב ע ר פ י ר נ
אריי־	א ר י י
ארייווים	א ר י י ו ו י מ
אריין	א ר י י נ
אריינברענגען	א ר י י נ ב ר ע נ ג ע נ
אריינגייענדיג	א ר י י נ ג י י ע נ ד י ג
אריינגעבראכט	א ר י י נ ג ע ב ר א כ ט
אריינגעבראקט	א ר י י נ ג ע ב ר א ק ט
אריינגעגאסן	א ר י י נ ג ע ג א ס נ
אריינגעגעבן	א ר י י נ ג ע ג ע ב נ
אריינגעדרייט	א ר י י נ ג ע ד ר י י ט
אריינגעדרענגט	א ר י י נ ג ע ד ר ע נ ג ט
אריינגעזעצטע	א ר י י נ ג ע ז ע צ ט ע
אריינגעטיילט	א ר י י נ ג ע ט י י ל ט
אריינגעטראגן	א ר י י נ ג ע ט ר א ג נ
אריינגעכאפט	א ר י י נ ג ע כ א פ ט
אריינגעלאזט	א ר י י נ ג ע ל א ז ט
אריינגעלייגט	א ר י י נ ג ע ל י י ג ט
אריינגעמישט	א ר י י נ ג ע מ י ש ט
אריינגענומען	א ר י י נ ג ע נ ו מ ע נ
אריינגעפאלן	א ר י י נ ג ע פ א ל נ
אריינגעפאסטע	א ר י י נ ג ע פ א ס ט ע
אריינגעפירט	א ר י י נ ג ע פ י ר ט
אריינגעפלאנטעט	א ר י י נ ג ע פ ל א נ ט ע ט
אריינגעפלאסן	א ר י י נ ג ע פ ל א ס נ
אריינגעפליאסקעט	א ר י י נ ג ע פ ל י א ס ק ע ט
אריינגעצויגן	א ר י י נ ג ע צ ו י ג נ
אריינגעקאטשעט	א ר י י נ ג ע ק א ט ש ע ט
אריינגעקומען	א ר י י נ ג ע ק ו מ ע נ
אריינגעקוקט	א ר י י נ ג ע ק ו ק ט
אריינגעקלאפט	א ר י י נ ג ע ק ל א פ ט
אריינגערופן	א ר י י נ ג ע ר ו פ נ
אריינגערוקט	א ר י י נ ג ע ר ו ק ט
אריינגעשוואומען	א ר י י נ ג ע ש ו ו א ו מ ע נ
אריינגעשטעלט	א ר י י נ ג ע ש ט ע ל ט
אריינגעשטעקט	א ר י י נ ג ע ש ט ע ק ט
אריינגעשטרייכטע	א ר י י נ ג ע ש ט ר י י כ ט ע
אריינגעשריגן	א ר י י נ ג ע ש ר י ג נ
אריינדרייען	א ר י י נ ד ר י י ע נ
אריינווארפן	א ר י י נ ו ו א ר פ נ
אריינזעצן	א ר י י נ ז ע צ נ
אריינטראגן	א ר י י נ ט ר א ג נ
אריינטרעטן	א ר י י נ ט ר ע ט נ
אריינכאפן	א ר י י נ כ א פ נ
אריינלייגן	א ר י י נ ל י י ג נ
אריינלייגנדיג	א ר י י נ ל י י ג נ ד י ג
אריינצו'גנב'ענען	א ר י י נ צ ו ג נ ב ע נ ע נ
אריינצונעמען	א ר י י נ צ ו נ ע מ ע נ
אריינצוקומען	א ר י י נ צ ו ק ו מ ע נ
אריינצוקוקן	א ר י י נ צ ו ק ו ק נ
אריינקומען	א ר י י נ ק ו מ ע נ
אריינקוקן	א ר י י נ ק ו ק נ
אריינרוקן	א ר י י נ ר ו ק נ
אריינרעכענען	א ר י י נ ר ע כ ע נ ע נ
אריינשטעקן	א ר י י נ ש ט ע ק נ
ארים	א ר י מ
ארימאן	א ר י מ א נ
ארימס	א ר י מ ס
ארימע	א ר י מ ע
ארימקייט	א ר י מ ק י י ט
אריסטאקראטיש	א ר י ס ט א ק ר א ט י ש
אריסטאקראטישער	א ר י ס ט א ק ר א ט י ש ע ר
ארן	א ר נ
ארנטליכע	א ר נ ט ל י כ ע
ארעוו	א ר ע ו ו
ארעסט	א ר ע ס ט
ארץ־ישראל־עפעלעך	א ר צ י ש ר א ל ע פ ע ל ע כ
אש	א ש
אש־להבה	א ש ל ה ב ה
אשכנזים	א ש כ נ ז י מ
אשרי	א ש ר י
אשת־איש	א ש ת א י ש
אתה	א ת ה
אתה־הראיתלע	א ת ה ה ר א י ת ל ע
אתרוגים	א ת ר ו ג י מ
באב	ב א ב
באבולע	ב א ב ו ל ע
באבע	ב א ב ע
באבעס	ב א ב ע ס
באבעצע	ב א ב ע צ ע
באבעשי	ב א ב ע ש י
באגיין	ב א ג י י נ
באגייסטערונג	ב א ג י י ס ט ע ר ו נ ג
באגילדעט	ב א ג י ל ד ע ט
באגליקן	ב א ג ל י ק נ
באגעגנט	ב א ג ע ג נ ט
באגעגענישן	ב א ג ע ג ע נ י ש נ
באגערן	ב א ג ע ר נ
באגראבן	ב א ג ר א ב נ
באד	ב א ד
באדארף	ב א ד א ר ף
באדארפט	ב א ד א ר פ ט
באדארפן	ב א ד א ר פ נ
באדויערט	ב א ד ו י ע ר ט
באדויערן	ב א ד ו י ע ר נ
באדט	ב א ד ט
באדייט	ב א ד י י ט
באדינג	ב א ד י נ ג
באדן	ב א ד נ
באדנדיג	ב א ד נ ד י ג
באדעקט	ב א ד ע ק ט
באדעקן	ב א ד ע ק נ
באהאלט	ב א ה א ל ט
באהאלטן	ב א ה א ל ט נ
באהאלטענע	ב א ה א ל ט ע נ ע
באהאלטענער	ב א ה א ל ט ע נ ע ר
באהאנגען	ב א ה א נ ג ע נ
באהאפטן	ב א ה א פ ט נ
באהויכט	ב א ה ו י כ ט
באהיט	ב א ה י ט
באהעלט	ב א ה ע ל ט
באהעלטעניש	ב א ה ע ל ט ע נ י ש
באהעלפער	ב א ה ע ל פ ע ר
באהעפט	ב א ה ע פ ט
באוואויגן	ב א ו ו א ו י ג נ
באוואוסט	ב א ו ו א ו ס ט
באוואוסטן	ב א ו ו א ו ס ט נ
באוואקסענער	ב א ו ו א ק ס ע נ ע ר
באווארנט	ב א ו ו א ר נ ט
באווארענען	ב א ו ו א ר ע נ ע נ
באוויזן	ב א ו ו י ז נ
באווייבטער	ב א ו ו י י ב ט ע ר
באווייז	ב א ו ו י י ז
באווייזט	ב א ו ו י י ז ט
באווייזן	ב א ו ו י י ז נ
באוויינען	ב א ו ו י י נ ע נ
באוועבט	ב א ו ו ע ב ט
באוועגט	ב א ו ו ע ג ט
באוועגן	ב א ו ו ע ג נ
באזוכן	ב א ז ו כ נ
באזונדער	ב א ז ו נ ד ע ר
באזונדערן	ב א ז ו נ ד ע ר נ
באזונדערע	ב א ז ו נ ד ע ר ע
באזונדערער	ב א ז ו נ ד ע ר ע ר
באזעצט	ב א ז ע צ ט
באחנט	ב א ח נ ט
באט	ב א ט
באטאפן	ב א ט א פ נ
באטעמט	ב א ט ע מ ט
באטראכט	ב א ט ר א כ ט
באטראכטן	ב א ט ר א כ ט נ
באלד	ב א ל ד
באלוואן	ב א ל ו ו א נ
באלויכטן	ב א ל ו י כ ט נ
באלוינט	ב א ל ו י נ ט
באלייגט	ב א ל י י ג ט
באליידיגט	ב א ל י י ד י ג ט
באלייע	ב א ל י י ע
באלע־מעלאכעס	ב א ל ע מ ע ל א כ ע ס
באלעבאטים	ב א ל ע ב א ט י מ
באלעגאלעס	ב א ל ע ג א ל ע ס
באלקן	ב א ל ק נ
באלקע	ב א ל ק ע
באמערק	ב א מ ע ר ק
באמערקונג	ב א מ ע ר ק ו נ ג
באמערקונגען	ב א מ ע ר ק ו נ ג ע נ
באמערקט	ב א מ ע ר ק ט
באמערקן	ב א מ ע ר ק נ
באמערקנדיג	ב א מ ע ר ק נ ד י ג
באמקעט	ב א מ ק ע ט
באן	ב א נ
באנג	ב א נ ג
באנד	ב א נ ד
באנטשע	ב א נ ט ש ע
באנטשען	ב א נ ט ש ע נ
באנטשעס	ב א נ ט ש ע ס
באנק	ב א נ ק
באנקעליך	ב א נ ק ע ל י כ
באנקעס	ב א נ ק ע ס
באנקראטירט	ב א נ ק ר א ט י ר ט
באפאלן	ב א פ א ל נ
באפוילן	ב א פ ו י ל נ
באפלעקטע	ב א פ ל ע ק ט ע
באפעל	ב א פ ע ל
באפעלט	ב א פ ע ל ט
באפעלן	ב א פ ע ל נ
באפעסטיגט	ב א פ ע ס ט י ג ט
באפריינדעט	ב א פ ר י י נ ד ע ט
באפרישט	ב א פ ר י ש ט
באצאלט	ב א צ א ל ט
באצאלן	ב א צ א ל נ
באק	ב א ק
באקאנט	ב א ק א נ ט
באקאנטן	ב א ק א נ ט נ
באקאנטע	ב א ק א נ ט ע
באקאנטער	ב א ק א נ ט ע ר
באקום	ב א ק ו מ
באקומט	ב א ק ו מ ט
באקומען	ב א ק ו מ ע נ
באקומענדיג	ב א ק ו מ ע נ ד י ג
באקוקט	ב א ק ו ק ט
באקוקן	ב א ק ו ק נ
באקט	ב א ק ט
באקלאגט	ב א ק ל א ג ט
באקלאגן	ב א ק ל א ג נ
באקלאפט	ב א ק ל א פ ט
באקלאפעכץ	ב א ק ל א פ ע כ צ
באקליידט	ב א ק ל י י ד ט
באקן	ב א ק נ
באקענען	ב א ק ע נ ע נ
באר	ב א ר
באראטן	ב א ר א ט נ
בארג	ב א ר ג
בארג־אראפ	ב א ר ג א ר א פ
בארגן	ב א ר ג נ
בארד	ב א ר ד
בארואיגן	ב א ר ו א י ג נ
בארוועס	ב א ר ו ו ע ס
בארוועסע	ב א ר ו ו ע ס ע
בארימט	ב א ר י מ ט
בארימטע	ב א ר י מ ט ע
בארימטער	ב א ר י מ ט ע ר
בארימען	ב א ר י מ ע נ
בארירט	ב א ר י ר ט
בארן	ב א ר נ
בארנעס	ב א ר נ ע ס
בארעכנט	ב א ר ע כ נ ט
בארשט	ב א ר ש ט
באשאפן	ב א ש א פ נ
באשולדיגונג	ב א ש ו ל ד י ג ו נ ג
באשטייט	ב א ש ט י י ט
באשטיין	ב א ש ט י י נ
באשטימט	ב א ש ט י מ ט
באשטעלט	ב א ש ט ע ל ט
באשטענדיג	ב א ש ט ע נ ד י ג
באשטענדיגע	ב א ש ט ע נ ד י ג ע
באשטענדיגער	ב א ש ט ע נ ד י ג ע ר
באשיימפערליך	ב א ש י י מ פ ע ר ל י כ
באשיצט	ב א ש י צ ט
באשיצן	ב א ש י צ נ
באשעפעניש	ב א ש ע פ ע נ י ש
באשעפער	ב א ש ע פ ע ר
באשערט	ב א ש ע ר ט
באשפיגן	ב א ש פ י ג נ
באשפייט	ב א ש פ י י ט
באשפריצט	ב א ש פ ר י צ ט
באשר	ב א ש ר
באשריבן	ב א ש ר י ב נ
באשרייבן	ב א ש ר י י ב נ
בגד	ב ג ד
בגדים	ב ג ד י מ
בדעה	ב ד ע ה
בהלה	ב ה ל ה
בהמה	ב ה מ ה
בהמהלע	ב ה מ ה ל ע
בהמות	ב ה מ ו ת
בהן־שלי	ב ה נ ש ל י
בוזעם־קעשענע	ב ו ז ע מ ק ע ש ע נ ע
בוטלקוואס	ב ו ט ל ק ו ו א ס
בויבעריג	ב ו י ב ע ר י ג
בויבעריגער	ב ו י ב ע ר י ג ע ר
בויגט	ב ו י ג ט
בויגל	ב ו י ג ל
בויגן	ב ו י ג נ
בוידעם	ב ו י ד ע מ
בויך	ב ו י כ
בוים	ב ו י מ
בוימל	ב ו י מ ל
בוימס	ב ו י מ ס
בוימער	ב ו י מ ע ר
בויען	ב ו י ע נ
בוך	ב ו כ
בוכשטאב	ב ו כ ש ט א ב
בולאנעס	ב ו ל א נ ע ס
בוליאן	ב ו ל י א נ
בולקע	ב ו ל ק ע
בולקעלעך	ב ו ל ק ע ל ע כ
בונד	ב ו נ ד
בונדן	ב ו נ ד נ
בונטיגע	ב ו נ ט י ג ע
בופלאקס	ב ו פ ל א ק ס
בורא	ב ו ר א
בורטשען	ב ו ר ט ש ע נ
בוריגע־בארשט	ב ו ר י ג ע ב א ר ש ט
בורעק	ב ו ר ע ק
בושה	ב ו ש ה
בושעס־האמעס	ב ו ש ע ס ה א מ ע ס
בזיון	ב ז י ו נ
בזיונות	ב ז י ו נ ו ת
בחור	ב ח ו ר
בחור'ווייז	ב ח ו ר ו ו י י ז
בחור'ל	ב ח ו ר ל
בחורים	ב ח ו ר י מ
בחרם	ב ח ר מ
בטבע	ב ט ב ע
בטוח	ב ט ו ח
בטחון	ב ט ח ו נ
בטל	ב ט ל
בידנע	ב י ד נ ע
ביז	ב י ז
ביזן	ב י ז נ
ביטער	ב י ט ע ר
ביטערע	ב י ט ע ר ע
ביי	ב י י
בייגט	ב י י ג ט
בייגל	ב י י ג ל
בייגל־בעקער	ב י י ג ל ב ע ק ע ר
בייגעטראגן	ב י י ג ע ט ר א ג נ
ביידל	ב י י ד ל
ביידן	ב י י ד נ
ביידע	ב י י ד ע
בייזן	ב י י ז נ
בייזע	ב י י ז ע
בייזער	ב י י ז ע ר
בייזערט	ב י י ז ע ר ט
בייט	ב י י ט
בייטאג	ב י י ט א ג
בייטל	ב י י ט ל
בייטן	ב י י ט נ
בייטש	ב י י ט ש
בייטשן	ב י י ט ש נ
בייכיגע	ב י י כ י ג ע
בייכל	ב י י כ ל
בייכלעך	ב י י כ ל ע כ
בייכער	ב י י כ ע ר
ביים	ב י י מ
ביימל	ב י י מ ל
ביימלעך	ב י י מ ל ע כ
ביימעלע	ב י י מ ע ל ע
ביימעלעך	ב י י מ ע ל ע כ
ביימער	ב י י מ ע ר
ביין	ב י י נ
ביינאכט	ב י י נ א כ ט
ביינאנד	ב י י נ א נ ד
ביינדל	ב י י נ ד ל
ביינער	ב י י נ ע ר
ביינערדיגע	ב י י נ ע ר ד י ג ע
בייס	ב י י ס
ביישפיל	ב י י ש פ י ל
ביכל	ב י כ ל
בילדער	ב י ל ד ע ר
ביליג	ב י ל י ג
ביליגע	ב י ל י ג ע
ביליגער	ב י ל י ג ע ר
בילכער	ב י ל כ ע ר
בילן	ב י ל נ
בים־באם	ב י מ ב א מ
בימבאם	ב י מ ב א מ
בין	ב י נ
בינדט	ב י נ ד ט
בינטל	ב י נ ט ל
בינטלעך	ב י נ ט ל ע כ
ביסט	ב י ס ט
ביסטו	ב י ס ט ו
ביסל	ב י ס ל
ביסלעכווייז	ב י ס ל ע כ ו ו י י ז
ביסן	ב י ס נ
ביסעלע	ב י ס ע ל ע
ביצים	ב י צ י מ
ביר	ב י ר
בירגער	ב י ר ג ע ר
בירושה	ב י ר ו ש ה
בירכאסא	ב י ר כ א ס א
בית־דין	ב י ת ד י נ
בית־דין־שטוב	ב י ת ד י נ ש ט ו ב
בית־דין־של־מעלה	ב י ת ד י נ ש ל מ ע ל ה
בית־המדרש	ב י ת ה מ ד ר ש
בית־המדרש־געסל	ב י ת ה מ ד ר ש ג ע ס ל
בית־המיקדש	ב י ת ה מ י ק ד ש
בית־מדרש	ב י ת מ ד ר ש
בית־מדרש־פענסטער	ב י ת מ ד ר ש פ ע נ ס ט ע ר
בית־מדרשל	ב י ת מ ד ר ש ל
בית־עולם	ב י ת ע ו ל מ
בכבודיגערע	ב כ ב ו ד י ג ע ר ע
בכדי	ב כ ד י
בכל־תפוצות־ישראל	ב כ ל ת פ ו צ ו ת י ש ר א ל
בכן	ב כ נ
בלא־גוזמא	ב ל א ג ו ז מ א
בלאז	ב ל א ז
בלאזט	ב ל א ז ט
בלאט	ב ל א ט
בלאטיג	ב ל א ט י ג
בלאטע	ב ל א ט ע
בלאנדזשעט	ב ל א נ ד ז ש ע ט
בלאנדזשען	ב ל א נ ד ז ש ע נ
בלאנדע	ב ל א נ ד ע
בלאנקט	ב ל א נ ק ט
בלאנקען	ב ל א נ ק ע נ
בלאס	ב ל א ס
בלוט	ב ל ו ט
בלוט־שפראצנדיגע	ב ל ו ט ש פ ר א צ נ ד י ג ע
בלוטיג	ב ל ו ט י ג
בלוטיגן	ב ל ו ט י ג נ
בלוטן	ב ל ו ט נ
בלוי	ב ל ו י
בלויז	ב ל ו י ז
בלויזע	ב ל ו י ז ע
בלויע	ב ל ו י ע
בלויען	ב ל ו י ע נ
בלויער	ב ל ו י ע ר
בלומען	ב ל ו מ ע נ
בלומען־געשמאק	ב ל ו מ ע נ ג ע ש מ א ק
בלומען־פארקאוועטן	ב ל ו מ ע נ פ א ר ק א ו ו ע ט נ
בליטשקע	ב ל י ט ש ק ע
בלייב	ב ל י י ב
בלייבט	ב ל י י ב ט
בלייבן	ב ל י י ב נ
בלייכע	ב ל י י כ ע
בלייכער	ב ל י י כ ע ר
בלייענע	ב ל י י ע נ ע
בלייענעם	ב ל י י ע נ ע מ
בליישטיפטן	ב ל י י ש ט י פ ט נ
בליך	ב ל י כ
בלינדן	ב ל י נ ד נ
בלינדער	ב ל י נ ד ע ר
בליען	ב ל י ע נ
בליק	ב ל י ק
בלישטשעט	ב ל י ש ט ש ע ט
בלישטשען	ב ל י ש ט ש ע נ
בלעטל	ב ל ע ט ל
בלעטלעך	ב ל ע ט ל ע כ
בלעטעלעך	ב ל ע ט ע ל ע כ
בלעטער	ב ל ע ט ע ר
בלעכל	ב ל ע כ ל
בלעכנס	ב ל ע כ נ ס
בלעכענעם	ב ל ע כ ע נ ע מ
במילא	ב מ י ל א
במנהג	ב מ נ ה ג
במתנה	ב מ ת נ ה
בנאמנות	ב נ א מ נ ו ת
בני־בית	ב נ י ב י ת
בנים	ב נ י מ
בנעימותדיג	ב נ ע י מ ו ת ד י ג
בע	ב ע
בע־ייחוד	ב ע י י ח ו ד
בעדער	ב ע ד ע ר
בעדערס	ב ע ד ע ר ס
בעט	ב ע ט
בעטגעוואנט	ב ע ט ג ע ו ו א נ ט
בעטיי	ב ע ט י י
בעטל	ב ע ט ל
בעטלער	ב ע ט ל ע ר
בעטן	ב ע ט נ
בעיעשיווע	ב ע י ע ש י ו ו ע
בעך	ב ע כ
בעכעצי־כינעם	ב ע כ ע צ י כ י נ ע מ
בעכערליך	ב ע כ ע ר ל י כ
בעל־הבית	ב ע ל ה ב י ת
בעל־הבית'טע	ב ע ל ה ב י ת ט ע
בעל־הבית'טעס	ב ע ל ה ב י ת ט ע ס
בעל־הבתיש	ב ע ל ה ב ת י ש
בעל־הבתישן	ב ע ל ה ב ת י ש נ
בעל־הבתישע	ב ע ל ה ב ת י ש ע
בעל־הבתישקייט	ב ע ל ה ב ת י ש ק י י ט
בעל־חובות	ב ע ל ח ו ב ו ת
בעל־חשבון	ב ע ל ח ש ב ו נ
בעל־טובה	ב ע ל ט ו ב ה
בעל־ייחוס	ב ע ל י י ח ו ס
בעל־כרחך	ב ע ל כ ר ח כ
בעל־לשון־קודש	ב ע ל ל ש ו נ ק ו ד ש
בעל־מלאכה	ב ע ל מ ל א כ ה
בעל־מלאכות	ב ע ל מ ל א כ ו ת
בעל־נצחון	ב ע ל נ צ ח ו נ
בעל־עבירהניג	ב ע ל ע ב י ר ה נ י ג
בעל־פרנסה	ב ע ל פ ר נ ס ה
בעל־צדקה	ב ע ל צ ד ק ה
בעל־תנך	ב ע ל ת נ כ
בעלי־בתים	ב ע ל י ב ת י מ
בעלי־חובות	ב ע ל י ח ו ב ו ת
בעלי־עבירות	ב ע ל י ע ב י ר ו ת
בעלמע	ב ע ל מ ע
בעלן	ב ע ל נ
בעלנים	ב ע ל נ י מ
בעלע	ב ע ל ע
בענדער	ב ע נ ד ע ר
בענדערנע	ב ע נ ד ע ר נ ע
בענטשט	ב ע נ ט ש ט
בענטשן	ב ע נ ט ש נ
בעניע	ב ע נ י ע
בענק	ב ע נ ק
בענקט	ב ע נ ק ט
בענקל	ב ע נ ק ל
בענקעלע	ב ע נ ק ע ל ע
בענקען	ב ע נ ק ע נ
בענקעניש	ב ע נ ק ע נ י ש
בעסטן	ב ע ס ט נ
בעסטע	ב ע ס ט ע
בעסטער	ב ע ס ט ע ר
בעסער	ב ע ס ע ר
בעסערן	ב ע ס ע ר נ
בעער־מים־חיים	ב ע ע ר מ י מ ח י י מ
בעקן	ב ע ק נ
בעקנס	ב ע ק נ ס
בעקעלעך	ב ע ק ע ל ע כ
בעקער	ב ע ק ע ר
בעקעריי	ב ע ק ע ר י י
בעקערס	ב ע ק ע ר ס
בעראוו	ב ע ר א ו ו
בערג	ב ע ר ג
בערגאמאטן	ב ע ר ג א מ א ט נ
בערגל	ב ע ר ג ל
בערגער	ב ע ר ג ע ר
בערד	ב ע ר ד
בערדל	ב ע ר ד ל
בערישע	ב ע ר י ש ע
בערל	ב ע ר ל
בערלינקעס	ב ע ר ל י נ ק ע ס
בערלען	ב ע ר ל ע נ
בעשויפער	ב ע ש ו י פ ע ר
בעת	ב ע ת
בפירוש	ב פ י ר ו ש
בפירושע	ב פ י ר ו ש ע
בפרט	ב פ ר ט
בצלאל	ב צ ל א ל
בקיצור	ב ק י צ ו ר
בקשה	ב ק ש ה
בר־דעת	ב ר ד ע ת
בר־מזל	ב ר מ ז ל
בר־מצוה	ב ר מ צ ו ה
בראט	ב ר א ט
בראטן	ב ר א ט נ
בראטפאנען	ב ר א ט פ א נ ע נ
בראך	ב ר א כ
בראנפן	ב ר א נ פ נ
בראנפנס	ב ר א נ פ נ ס
בראצקי	ב ר א צ ק י
בראקן	ב ר א ק נ
ברואים	ב ר ו א י מ
ברוגז	ב ר ו ג ז
ברוגז־מינע	ב ר ו ג ז מ י נ ע
ברודיגע	ב ר ו ד י ג ע
ברודער	ב ר ו ד ע ר
ברודערל	ב ר ו ד ע ר ל
ברודערס	ב ר ו ד ע ר ס
ברויט	ב ר ו י ט
ברוין	ב ר ו י נ
ברוך	ב ר ו כ
ברוך־השם	ב ר ו כ ה ש מ
ברוך־שעאמער	ב ר ו כ ש ע א מ ע ר
ברוכס	ב ר ו כ ס
ברומט	ב ר ו מ ט
ברונעם	ב ר ו נ ע מ
ברוסט	ב ר ו ס ט
ברוק	ב ר ו ק
ברידער	ב ר י ד ע ר
ברידערליך	ב ר י ד ע ר ל י כ
בריה	ב ר י ה
בריהשאפט	ב ר י ה ש א פ ט
בריוו	ב ר י ו ו
בריוול	ב ר י ו ו ל
בריוועלע	ב ר י ו ו ע ל ע
בריטשקע	ב ר י ט ש ק ע
ברייט	ב ר י י ט
ברייט־בייניגער	ב ר י י ט ב י י נ י ג ע ר
ברייטן	ב ר י י ט נ
ברייטס	ב ר י י ט ס
ברייטסטע	ב ר י י ט ס ט ע
ברייטע	ב ר י י ט ע
ברייטער	ב ר י י ט ע ר
ברייען	ב ר י י ע נ
בריליאנט	ב ר י ל י א נ ט
בריליאנטן	ב ר י ל י א נ ט נ
בריליאנטענע	ב ר י ל י א נ ט ע נ ע
ברילן	ב ר י ל נ
בריסט	ב ר י ס ט
בריסטן	ב ר י ס ט נ
בריענדיג	ב ר י ע נ ד י ג
בריענדיגע	ב ר י ע נ ד י ג ע
ברירה	ב ר י ר ה
ברית	ב ר י ת
ברית־מילה	ב ר י ת מ י ל ה
ברכה	ב ר כ ה
ברכהן	ב ר כ ה נ
ברכות	ב ר כ ו ת
ברעג	ב ר ע ג
ברעטל	ב ר ע ט ל
ברעטער	ב ר ע ט ע ר
ברעך	ב ר ע כ
ברעכט	ב ר ע כ ט
ברעכן	ב ר ע כ נ
ברעם	ב ר ע מ
ברעמען	ב ר ע מ ע נ
ברען	ב ר ע נ
ברענגט	ב ר ע נ ג ט
ברענגען	ב ר ע נ ג ע נ
ברענט	ב ר ע נ ט
ברענען	ב ר ע נ ע נ
ברענענדיגע	ב ר ע נ ע נ ד י ג ע
בשום־אופן	ב ש ו מ א ו פ נ
בשום־ענין־ואופן	ב ש ו מ ע נ י נ ו א ו פ נ
בשורה	ב ש ו ר ה
בשורות	ב ש ו ר ו ת
בשלום	ב ש ל ו מ
בשמחה	ב ש מ ח ה
בשעת	ב ש ע ת
בשעת־האדאכאק	ב ש ע ת ה א ד א כ א ק
בשעת־האדאכעק	ב ש ע ת ה א ד א כ ע ק
בשעת־מעשה	ב ש ע ת מ ע ש ה
בשעתן	ב ש ע ת נ
בת־זקנים	ב ת ז ק נ י מ
בתי־מדרשים	ב ת י מ ד ר ש י מ
בתנאי	ב ת נ א י
גאאאאאט	ג א א א א א ט
גאדאל	ג א ד א ל
גאדלע	ג א ד ל ע
גאוה	ג א ו ה
גאזשע	ג א ז ש ע
גאט	ג א ט
גאטס	ג א ט ס
גאטעס	ג א ט ע ס
גאטעסדינסט	ג א ט ע ס ד י נ ס ט
גאל	ג א ל
גאלד	ג א ל ד
גאלדע	ג א ל ד ע
גאלדעלע	ג א ל ד ע ל ע
גאלדען	ג א ל ד ע נ
גאלדענע	ג א ל ד ע נ ע
גאלדענעם	ג א ל ד ע נ ע מ
גאלדענער	ג א ל ד ע נ ע ר
גאלדעס	ג א ל ד ע ס
גאלדשמיד	ג א ל ד ש מ י ד
גאלי	ג א ל י
גאליאסיינו	ג א ל י א ס י י נ ו
גאליש־עפעלעך	ג א ל י ש ע פ ע ל ע כ
גאלע	ג א ל ע
גאמבין	ג א מ ב י נ
גאמבינער	ג א מ ב י נ ע ר
גאמבינערס	ג א מ ב י נ ע ר ס
גאמבע	ג א מ ב ע
גאנג	ג א נ ג
גאנדז	ג א נ ד ז
גאנץ	ג א נ צ
גאנצן	ג א נ צ נ
גאנצע	ג א נ צ ע
גאנצער	ג א נ צ ע ר
גאס	ג א ס
גאס־אויס	ג א ס א ו י ס
גאס־איין	ג א ס א י י נ
גאסט	ג א ס ט
גאסטהויז	ג א ס ט ה ו י ז
גאסן	ג א ס נ
גאפל	ג א פ ל
גאפלען	ג א פ ל ע נ
גאר	ג א ר
גארדינען	ג א ר ד י נ ע נ
גארטל	ג א ר ט ל
גארטלען	ג א ר ט ל ע נ
גארטן	ג א ר ט נ
גארניט	ג א ר נ י ט
גארנישט	ג א ר נ י ש ט
גבאי	ג ב א י
גבאיטע	ג ב א י ט ע
גבאים	ג ב א י מ
גבאיס	ג ב א י ס
גבורה	ג ב ו ר ה
גביר	ג ב י ר
גבירטע	ג ב י ר ט ע
גבריאל	ג ב ר י א ל
גגג	ג ג ג
גדולה	ג ד ו ל ה
גדליה	ג ד ל י ה
גוואלד	ג ו ו א ל ד
גוואלדעוועט	ג ו ו א ל ד ע ו ו ע ט
גווארדיע	ג ו ו א ר ד י ע
גוזמא	ג ו ז מ א
גוט	ג ו ט
גוט־וואך	ג ו ט ו ו א כ
גוט־וואכס	ג ו ט ו ו א כ ס
גוט־יאר	ג ו ט י א ר
גוט־יום־טוב	ג ו ט י ו מ ט ו ב
גוט־מארגן	ג ו ט מ א ר ג נ
גוטן	ג ו ט נ
גוטס	ג ו ט ס
גוטסקייט	ג ו ט ס ק י י ט
גוטע	ג ו ט ע
גוטער	ג ו ט ע ר
גוי	ג ו י
גויים	ג ו י י מ
גוייש	ג ו י י ש
גויישן	ג ו י י ש נ
גויישע	ג ו י י ש ע
גויעס	ג ו י ע ס
גולמס	ג ו ל מ ס
גומענע	ג ו מ ע נ ע
גוססן	ג ו ס ס נ
גופא	ג ו פ א
גזלות	ג ז ל ו ת
גזלעוואויע	ג ז ל ע ו ו א ו י ע
גטן	ג ט נ
גיב	ג י ב
גיב־מיר־נאך	ג י ב מ י ר נ א כ
גיבורים	ג י ב ו ר י מ
גיבן	ג י ב נ
גיהנום	ג י ה נ ו מ
גיט	ג י ט
גיי	ג י י
גייט	ג י י ט
גיין	ג י י נ
גייסט	ג י י ס ט
גייען	ג י י ע נ
גייענדיג	ג י י ע נ ד י ג
גיך	ג י כ
גיך־גיך	ג י כ ג י כ
גיכער	ג י כ ע ר
גיכקייט	ג י כ ק י י ט
גילדן	ג י ל ד נ
גינגאלד	ג י נ ג א ל ד
גינגאלדענע	ג י נ ג א ל ד ע נ ע
גיס	ג י ס
גיסט	ג י ס ט
גיסן	ג י ס נ
גלאז	ג ל א ז
גלאזל	ג ל א ז ל
גלאט	ג ל א ט
גלאנץ	ג ל א נ צ
גלאנצט	ג ל א נ צ ט
גלאנצן	ג ל א נ צ נ
גלאנצנדיגן	ג ל א נ צ נ ד י ג נ
גלאנצנדיגס	ג ל א נ צ נ ד י ג ס
גלאנצעדיגן	ג ל א נ צ ע ד י ג נ
גלאק	ג ל א ק
גלגול	ג ל ג ו ל
גלגולים	ג ל ג ו ל י מ
גלויב	ג ל ו י ב
גלויבט	ג ל ו י ב ט
גלויבן	ג ל ו י ב נ
גלוסט	ג ל ו ס ט
גלוסטן	ג ל ו ס ט נ
גלופסק	ג ל ו פ ס ק
גלופסקער	ג ל ו פ ס ק ע ר
גלות	ג ל ו ת
גלחס	ג ל ח ס
גליד	ג ל י ד
גלידער	ג ל י ד ע ר
גליט	ג ל י ט
גליטש	ג ל י ט ש
גליטשט	ג ל י ט ש ט
גליטשיג	ג ל י ט ש י ג
גלייבט	ג ל י י ב ט
גלייבן	ג ל י י ב נ
גלייך	ג ל י י כ
גלייכגילטיג	ג ל י י כ ג י ל ט י ג
גלייכווערטלעך	ג ל י י כ ו ו ע ר ט ל ע כ
גלייכן	ג ל י י כ נ
גלייכע	ג ל י י כ ע
גלייכער	ג ל י י כ ע ר
גליצערינע	ג ל י צ ע ר י נ ע
גליק	ג ל י ק
גליקלעך	ג ל י ק ל ע כ
גליקלעכער	ג ל י ק ל ע כ ע ר
גליקן	ג ל י ק נ
גלעזל	ג ל ע ז ל
גלעזלעך	ג ל ע ז ל ע כ
גלעזעלע	ג ל ע ז ע ל ע
גלעזער	ג ל ע ז ע ר
גלעזערנע	ג ל ע ז ע ר נ ע
גלעזערנער	ג ל ע ז ע ר נ ע ר
גלעט	ג ל ע ט
גלעטנדיג	ג ל ע ט נ ד י ג
גלענצנדיגן	ג ל ע נ צ נ ד י ג נ
גמרא	ג מ ר א
גמרא־ניגון'דל	ג מ ר א נ י ג ו נ ד ל
גמרות	ג מ ר ו ת
גן־עדן	ג נ ע ד נ
גנאטעווען	ג נ א ט ע ו ו ע נ
גנב	ג נ ב
גנב'ה	ג נ ב ה
גנב'השע	ג נ ב ה ש ע
גנב'עט	ג נ ב ע ט
גנב'ענען	ג נ ב ע נ ע נ
גנבים	ג נ ב י מ
גניבות	ג נ י ב ו ת
גע'גנב'עט	ג ע ג נ ב ע ט
גע'הרג'עט	ג ע ה ר ג ע ט
גע'הרג'עטנס	ג ע ה ר ג ע ט נ ס
גע'חזר'ט	ג ע ח ז ר ט
גע'רעש'ט	ג ע ר ע ש ט
געאיילט	ג ע א י י ל ט
געאייניגט	ג ע א י י נ י ג ט
געארבעט	ג ע א ר ב ע ט
געארט	ג ע א ר ט
געארעמט	ג ע א ר ע מ ט
געבאקן	ג ע ב א ק נ
געבויגט	ג ע ב ו י ג ט
געבויגן	ג ע ב ו י ג נ
געבוירן	ג ע ב ו י ר נ
געבונדן	ג ע ב ו נ ד נ
געבייזער	ג ע ב י י ז ע ר
געביסן	ג ע ב י ס נ
געבלאזט	ג ע ב ל א ז ט
געבליבן	ג ע ב ל י ב נ
געבליצט	ג ע ב ל י צ ט
געבלעטערט	ג ע ב ל ע ט ע ר ט
געבן	ג ע ב נ
געבנדיג	ג ע ב נ ד י ג
געבעט	ג ע ב ע ט
געבעטלט	ג ע ב ע ט ל ט
געבעטן	ג ע ב ע ט נ
געבענקט	ג ע ב ע נ ק ט
געבעקס	ג ע ב ע ק ס
געבערקעס	ג ע ב ע ר ק ע ס
געבראטנס	ג ע ב ר א ט נ ס
געבראטענע	ג ע ב ר א ט ע נ ע
געבראכט	ג ע ב ר א כ ט
געברומט	ג ע ב ר ו מ ט
געבריהט	ג ע ב ר י ה ט
געברענט	ג ע ב ר ע נ ט
געגאנגען	ג ע ג א נ ג ע נ
געגאסן	ג ע ג א ס נ
געגט	ג ע ג ט
געגילטע	ג ע ג י ל ט ע
געגלייבט	ג ע ג ל י י ב ט
געגליכן	ג ע ג ל י כ נ
געגלעט	ג ע ג ל ע ט
געגן	ג ע ג נ
געגנט	ג ע ג נ ט
געגעבן	ג ע ג ע ב נ
געגעסן	ג ע ג ע ס נ
געגרייט	ג ע ג ר י י ט
געגריסט	ג ע ג ר י ס ט
געדאוונט	ג ע ד א ו ו נ ט
געדאכט	ג ע ד א כ ט
געדאנק	ג ע ד א נ ק
געדאנקט	ג ע ד א נ ק ט
געדאנקען	ג ע ד א נ ק ע נ
געדיכטן	ג ע ד י כ ט נ
געדיכטע	ג ע ד י כ ט ע
געדיכטער	ג ע ד י כ ט ע ר
געדעכעניש	ג ע ד ע כ ע נ י ש
געדענק	ג ע ד ע נ ק
געדענקט	ג ע ד ע נ ק ט
געדענקען	ג ע ד ע נ ק ע נ
געדעקט	ג ע ד ע ק ט
געדערעם	ג ע ד ע ר ע מ
געדרונגען	ג ע ד ר ו נ ג ע נ
געדרייט	ג ע ד ר י י ט
געדרייטע	ג ע ד ר י י ט ע
געדריקט	ג ע ד ר י ק ט
געהאדעוועט	ג ע ה א ד ע ו ו ע ט
געהאדעוועטע	ג ע ה א ד ע ו ו ע ט ע
געהאט	ג ע ה א ט
געהאלטן	ג ע ה א ל ט נ
געהאלפן	ג ע ה א ל פ נ
געהאנגען	ג ע ה א נ ג ע נ
געהאנדלט	ג ע ה א נ ד ל ט
געהאפטענע	ג ע ה א פ ט ע נ ע
געהאקט	ג ע ה א ק ט
געהארכט	ג ע ה א ר כ ט
געהויבן	ג ע ה ו י ב נ
געהויבענע	ג ע ה ו י ב ע נ ע
געהויכט	ג ע ה ו י כ ט
געהוסט	ג ע ה ו ס ט
געהיט	ג ע ה י ט
געהיימע	ג ע ה י י מ ע
געהיימען	ג ע ה י י מ ע נ
געהייסן	ג ע ה י י ס נ
געהייצט	ג ע ה י י צ ט
געהילט	ג ע ה י ל ט
געהילץ	ג ע ה י ל צ
געהירן	ג ע ה י ר נ
געהער	ג ע ה ע ר
געהערט	ג ע ה ע ר ט
געהערן	ג ע ה ע ר נ
געוו־	ג ע ו ו
געוואגט	ג ע ו ו א ג ט
געוואוינהייט	ג ע ו ו א ו י נ ה י י ט
געוואוינט	ג ע ו ו א ו י נ ט
געוואויר	ג ע ו ו א ו י ר
געוואוירע	ג ע ו ו א ו י ר ע
געוואונדערט	ג ע ו ו א ו נ ד ע ר ט
געוואוסט	ג ע ו ו א ו ס ט
געוואלגערט	ג ע ו ו א ל ג ע ר ט
געוואלד	ג ע ו ו א ל ד
געוואלדן	ג ע ו ו א ל ד נ
געוואלט	ג ע ו ו א ל ט
געוואקסן	ג ע ו ו א ק ס נ
געוואר	ג ע ו ו א ר
געווארט	ג ע ו ו א ר ט
געווארן	ג ע ו ו א ר נ
געווארפן	ג ע ו ו א ר פ נ
געוואשן	ג ע ו ו א ש נ
געוויגט	ג ע ו ו י ג ט
געוויזן	ג ע ו ו י ז נ
געוויין	ג ע ו ו י י נ
געוויינט	ג ע ו ו י י נ ט
געוויינלעכעס	ג ע ו ו י י נ ל ע כ ע ס
געוויכט	ג ע ו ו י כ ט
געווינען	ג ע ו ו י נ ע נ
געווינקט	ג ע ו ו י נ ק ט
געוויס	ג ע ו ו י ס
געוויסער	ג ע ו ו י ס ע ר
געווישט	ג ע ו ו י ש ט
געוועזן	ג ע ו ו ע ז נ
געוועזענע	ג ע ו ו ע ז ע נ ע
געוועט	ג ע ו ו ע ט
געוועלבער	ג ע ו ו ע ל ב ע ר
געווען	ג ע ו ו ע נ
געווענדעט	ג ע ו ו ע נ ד ע ט
געווענליך	ג ע ו ו ע נ ל י כ
געוועקט	ג ע ו ו ע ק ט
געזאגט	ג ע ז א ג ט
געזאלט	ג ע ז א ל ט
געזאלצן	ג ע ז א ל צ נ
געזאנג	ג ע ז א נ ג
געזאנגען	ג ע ז א נ ג ע נ
געזויגן	ג ע ז ו י ג נ
געזוכט	ג ע ז ו כ ט
געזונגען	ג ע ז ו נ ג ע נ
געזונט	ג ע ז ו נ ט
געזונטע	ג ע ז ו נ ט ע
געזונטער	ג ע ז ו נ ט ע ר
געזונטערהייט	ג ע ז ו נ ט ע ר ה י י ט
געזונקען	ג ע ז ו נ ק ע נ
געזיכט	ג ע ז י כ ט
געזינדל	ג ע ז י נ ד ל
געזינטער	ג ע ז י נ ט ע ר
געזעגנט	ג ע ז ע ג נ ט
געזעהן	ג ע ז ע ה נ
געזעלשאפטליכע	ג ע ז ע ל ש א פ ט ל י כ ע
געזעס	ג ע ז ע ס
געזעסן	ג ע ז ע ס נ
געזעצט	ג ע ז ע צ ט
געחלומט	ג ע ח ל ו מ ט
געטוליעט	ג ע ט ו ל י ע ט
געטון	ג ע ט ו נ
געטונקען	ג ע ט ו נ ק ע נ
געטוקט	ג ע ט ו ק ט
געטייטלט	ג ע ט י י ט ל ט
געטיילט	ג ע ט י י ל ט
געטליכע	ג ע ט ל י כ ע
געטענהט	ג ע ט ע נ ה ט
געטראגן	ג ע ט ר א ג נ
געטראכט	ג ע ט ר א כ ט
געטראנק	ג ע ט ר א נ ק
געטראנקען	ג ע ט ר א נ ק ע נ
געטראפן	ג ע ט ר א פ נ
געטרוי	ג ע ט ר ו י
געטרויסט	ג ע ט ר ו י ס ט
געטרונקען	ג ע ט ר ו נ ק ע נ
געטריבן	ג ע ט ר י ב נ
געטרייסלט	ג ע ט ר י י ס ל ט
געטרייער	ג ע ט ר י י ע ר
געטריקנט	ג ע ט ר י ק נ ט
געטרערן	ג ע ט ר ע ר נ
געיאגט	ג ע י א ג ט
געכאפט	ג ע כ א פ ט
געכמארעט	ג ע כ מ א ר ע ט
געל	ג ע ל
געלאזט	ג ע ל א ז ט
געלאטעט	ג ע ל א ט ע ט
געלאכט	ג ע ל א כ ט
געלאפן	ג ע ל א פ נ
געלבליך	ג ע ל ב ל י כ
געלויבט	ג ע ל ו י ב ט
געלויכטן	ג ע ל ו י כ ט נ
געלויף	ג ע ל ו י ף
געלט	ג ע ל ט
געליבט	ג ע ל י ב ט
געליבטן	ג ע ל י ב ט נ
געליבטע	ג ע ל י ב ט ע
געליטן	ג ע ל י ט נ
געלייגט	ג ע ל י י ג ט
געליימט	ג ע ל י י מ ט
געליינט	ג ע ל י י נ ט
געלן	ג ע ל נ
געלע	ג ע ל ע
געלעבט	ג ע ל ע ב ט
געלעגן	ג ע ל ע ג נ
געלעגער	ג ע ל ע ג ע ר
געלעכטער	ג ע ל ע כ ט ע ר
געלעכטערל	ג ע ל ע כ ט ע ר ל
געלענקען	ג ע ל ע נ ק ע נ
געלעקט	ג ע ל ע ק ט
געלער	ג ע ל ע ר
געלערנט	ג ע ל ע ר נ ט
געמאכט	ג ע מ א כ ט
געמאכטע	ג ע מ א כ ט ע
געמאלט	ג ע מ א ל ט
געמאנט	ג ע מ א נ ט
געמאסטן	ג ע מ א ס ט נ
געמוזט	ג ע מ ו ז ט
געמוטשעט	ג ע מ ו ט ש ע ט
געמורמל	ג ע מ ו ר מ ל
געמורמלט	ג ע מ ו ר מ ל ט
געמיט	ג ע מ י ט
געמיטן	ג ע מ י ט נ
געמיינט	ג ע מ י י נ ט
געמינערט	ג ע מ י נ ע ר ט
געמישעכץ	ג ע מ י ש ע כ צ
געמעגט	ג ע מ ע ג ט
גענאגט	ג ע נ א ג ט
גענדז	ג ע נ ד ז
גענדזנשמאלץ	ג ע נ ד ז נ ש מ א ל צ
גענוג	ג ע נ ו ג
גענוגנדיגע	ג ע נ ו ג נ ד י ג ע
גענומען	ג ע נ ו מ ע נ
גענעענטערט	ג ע נ ע ע נ ט ע ר ט
געסאפעט	ג ע ס א פ ע ט
געסוויגן	ג ע ס ו ו י ג נ
געסטראשעט	ג ע ס ט ר א ש ע ט
געסטרעכירט	ג ע ס ט ר ע כ י ר ט
געסל	ג ע ס ל
געסליך	ג ע ס ל י כ
געסקריפעט	ג ע ס ק ר י פ ע ט
געענדיגט	ג ע ע נ ד י ג ט
געענדערט	ג ע ע נ ד ע ר ט
געעפנט	ג ע ע פ נ ט
געפאלן	ג ע פ א ל נ
געפאלענע	ג ע פ א ל ע נ ע
געפאסט	ג ע פ א ס ט
געפארן	ג ע פ א ר נ
געפגרט	ג ע פ ג ר ט
געפונען	ג ע פ ו נ ע נ
געפועלט	ג ע פ ו ע ל ט
געפטרט	ג ע פ ט ר ט
געפיטערט	ג ע פ י ט ע ר ט
געפייפט	ג ע פ י י פ ט
געפילדערט	ג ע פ י ל ד ע ר ט
געפילט	ג ע פ י ל ט
געפין	ג ע פ י נ
געפינט	ג ע פ י נ ט
געפינעט	ג ע פ י נ ע ט
געפינען	ג ע פ י נ ע נ
געפירט	ג ע פ י ר ט
געפלאכטענער	ג ע פ ל א כ ט ע נ ע ר
געפלאפלט	ג ע פ ל א פ ל ט
געפלאצט	ג ע פ ל א צ ט
געפלויגן	ג ע פ ל ו י ג נ
געפסקנט	ג ע פ ס ק נ ט
געפעלט	ג ע פ ע ל ט
געפעלן	ג ע פ ע ל נ
געפעפערטע	ג ע פ ע פ ע ר ט ע
געפרואווט	ג ע פ ר ו א ו ו ט
געפרוירן	ג ע פ ר ו י ר נ
געפרוירענע	ג ע פ ר ו י ר ע נ ע
געפרוירענער	ג ע פ ר ו י ר ע נ ע ר
געפרייט	ג ע פ ר י י ט
געפרעגט	ג ע פ ר ע ג ט
געפרעגלט	ג ע פ ר ע ג ל ט
געפרעגלטע	ג ע פ ר ע ג ל ט ע
געפרעסט	ג ע פ ר ע ס ט
געצאלטס	ג ע צ א ל ט ס
געצוואגן	ג ע צ ו ו א ג נ
געצווייפלט	ג ע צ ו ו י י פ ל ט
געצויגן	ג ע צ ו י ג נ
געצוקערט	ג ע צ ו ק ע ר ט
געצוקערטע	ג ע צ ו ק ע ר ט ע
געציילט	ג ע צ י י ל ט
געקאטשעט	ג ע ק א ט ש ע ט
געקאכט	ג ע ק א כ ט
געקאכטע	ג ע ק א כ ט ע
געקאמאנדעוועט	ג ע ק א מ א נ ד ע ו ו ע ט
געקאנט	ג ע ק א נ ט
געקאנטשעט	ג ע ק א נ ט ש ע ט
געקאסט	ג ע ק א ס ט
געקארגט	ג ע ק א ר ג ט
געקוויטשעט	ג ע ק ו ו י ט ש ע ט
געקוילעט	ג ע ק ו י ל ע ט
געקויפט	ג ע ק ו י פ ט
געקומען	ג ע ק ו מ ע נ
געקוקט	ג ע ק ו ק ט
געקלאגט	ג ע ק ל א ג ט
געקלאפט	ג ע ק ל א פ ט
געקלונגען	ג ע ק ל ו נ ג ע נ
געקליבן	ג ע ק ל י ב נ
געקלערט	ג ע ק ל ע ר ט
געקנאקט	ג ע ק נ א ק ט
געקנייטשט	ג ע ק נ י י ט ש ט
געקנייטשטן	ג ע ק נ י י ט ש ט נ
געקנייטשטע	ג ע ק נ י י ט ש ט ע
געקנייטשטער	ג ע ק נ י י ט ש ט ע ר
געקנייפט	ג ע ק נ י י פ ט
געקענט	ג ע ק ע נ ט
געקעניגט	ג ע ק ע נ י ג ט
געקעצלט	ג ע ק ע צ ל ט
געקראכן	ג ע ק ר א כ נ
געקראצט	ג ע ק ר א צ ט
געקרוינט	ג ע ק ר ו י נ ט
געקריגט	ג ע ק ר י ג ט
געקריגן	ג ע ק ר י ג נ
געקרעכצט	ג ע ק ר ע כ צ ט
געראטן	ג ע ר א ט נ
געראטעוועטער	ג ע ר א ט ע ו ו ע ט ע ר
געראטענע	ג ע ר א ט ע נ ע
געראטענער	ג ע ר א ט ע נ ע ר
גערודער	ג ע ר ו ד ע ר
גערוט	ג ע ר ו ט
גערויש	ג ע ר ו י ש
גערוישט	ג ע ר ו י ש ט
גערונען	ג ע ר ו נ ע נ
גערופן	ג ע ר ו פ נ
גערוקט	ג ע ר ו ק ט
גערייטלטע	ג ע ר י י ט ל ט ע
גערייכערט	ג ע ר י י כ ע ר ט
געריכט	ג ע ר י כ ט
געריסן	ג ע ר י ס נ
גערירט	ג ע ר י ר ט
גערן	ג ע ר נ
גערעדט	ג ע ר ע ד ט
גערעטעניש	ג ע ר ע ט ע נ י ש
גערעכט	ג ע ר ע כ ט
גערעכנט	ג ע ר ע כ נ ט
געשאט	ג ע ש א ט
געשאכטן	ג ע ש א כ ט נ
געשאלט	ג ע ש א ל ט
געשאלטן	ג ע ש א ל ט נ
געשאנקען	ג ע ש א נ ק ע נ
געשאקלט	ג ע ש א ק ל ט
געשוואוירן	ג ע ש ו ו א ו י ר נ
געשווארן	ג ע ש ו ו א ר נ
געשוויגן	ג ע ש ו ו י ג נ
געשוויצט	ג ע ש ו ו י צ ט
געשוועבט	ג ע ש ו ו ע ב ט
געשטאכן	ג ע ש ט א כ נ
געשטאלטן	ג ע ש ט א ל ט נ
געשטאמלט	ג ע ש ט א מ ל ט
געשטאנען	ג ע ש ט א נ ע נ
געשטאנק	ג ע ש ט א נ ק
געשטארבן	ג ע ש ט א ר ב נ
געשטויסן	ג ע ש ט ו י ס נ
געשטופט	ג ע ש ט ו פ ט
געשטימט	ג ע ש ט י מ ט
געשטעלט	ג ע ש ט ע ל ט
געשטעקט	ג ע ש ט ע ק ט
געשטרויכלט	ג ע ש ט ר ו י כ ל ט
געשטריקט	ג ע ש ט ר י ק ט
געשיינט	ג ע ש י י נ ט
געשיכטע	ג ע ש י כ ט ע
געשיקט	ג ע ש י ק ט
געשלאפן	ג ע ש ל א פ נ
געשליפן	ג ע ש ל י פ נ
געשליפענע	ג ע ש ל י פ ע נ ע
געשלעג	ג ע ש ל ע ג
געשלעפט	ג ע ש ל ע פ ט
געשמאק	ג ע ש מ א ק
געשמאקן	ג ע ש מ א ק נ
געשמועסט	ג ע ש מ ו ע ס ט
געשמועסן	ג ע ש מ ו ע ס נ
געשמייכלט	ג ע ש מ י י כ ל ט
געשמיסן	ג ע ש מ י ס נ
געשמירט	ג ע ש מ י ר ט
געשנייצט	ג ע ש נ י י צ ט
געשעמט	ג ע ש ע מ ט
געשען	ג ע ש ע נ
געשענקט	ג ע ש ע נ ק ט
געשעפט	ג ע ש ע פ ט
געשעפטן	ג ע ש ע פ ט נ
געשעצטעס	ג ע ש ע צ ט ע ס
געשפאן	ג ע ש פ א נ
געשפאנט	ג ע ש פ א נ ט
געשפיגן	ג ע ש פ י ג נ
געשפילט	ג ע ש פ י ל ט
געשפראצט	ג ע ש פ ר א צ ט
געשפרונגען	ג ע ש פ ר ו נ ג ע נ
געשפרעך	ג ע ש פ ר ע כ
געשריבן	ג ע ש ר י ב נ
געשריגן	ג ע ש ר י ג נ
געשריי	ג ע ש ר י י
געשריען	ג ע ש ר י ע נ
גראב	ג ר א ב
גראבן	ג ר א ב נ
גראבע	ג ר א ב ע
גראבער	ג ר א ב ע ר
גראד	ג ר א ד
גראז	ג ר א ז
גראטעס	ג ר א ט ע ס
גראס־אינקוויזיטארן	ג ר א ס א י נ ק ו ו י ז י ט א ר נ
גראף	ג ר א ף
גראפן	ג ר א פ נ
גראשן	ג ר א ש נ
גרוב	ג ר ו ב
גרוי	ג ר ו י
גרויס	ג ר ו י ס
גרויסן	ג ר ו י ס נ
גרויסע	ג ר ו י ס ע
גרויסעס	ג ר ו י ס ע ס
גרויסער	ג ר ו י ס ע ר
גרויע	ג ר ו י ע
גרויען	ג ר ו י ע נ
גרויער	ג ר ו י ע ר
גרונט	ג ר ו נ ט
גרוס	ג ר ו ס
גריבער	ג ר י ב ע ר
גריוון	ג ר י ו ו נ
גריוון־גערוך	ג ר י ו ו נ ג ע ר ו כ
גרייט	ג ר י י ט
גריכנלאנד	ג ר י כ נ ל א נ ד
גרימצארן	ג ר י מ צ א ר נ
גרין	ג ר י נ
גרינג	ג ר י נ ג
גרינגע	ג ר י נ ג ע
גרינגער	ג ר י נ ג ע ר
גרינינקע	ג ר י נ י נ ק ע
גרינליך	ג ר י נ ל י כ
גרינס	ג ר י נ ס
גרינע	ג ר י נ ע
גרינעם	ג ר י נ ע מ
גרינער	ג ר י נ ע ר
גרינערהייט	ג ר י נ ע ר ה י י ט
גריסט	ג ר י ס ט
גריסן	ג ר י ס נ
גרעזל	ג ר ע ז ל
גרעזליכס	ג ר ע ז ל י כ ס
גרעזעלע	ג ר ע ז ע ל ע
גרעזער	ג ר ע ז ע ר
גרעט	ג ר ע ט
גרעסטן	ג ר ע ס ט נ
גרעסטע	ג ר ע ס ט ע
גרעסטער	ג ר ע ס ט ע ר
גרעסער	ג ר ע ס ע ר
גרעסערן	ג ר ע ס ע ר נ
גרעסערע	ג ר ע ס ע ר ע
גרעסערער	ג ר ע ס ע ר ע ר
דא	ד א
דאבציע	ד א ב צ י ע
דאבציען	ד א ב צ י ע נ
דאגה	ד א ג ה
דאוון	ד א ו ו נ
דאוונט	ד א ו ו נ ט
דאוונען	ד א ו ו נ ע נ
דאווענען	ד א ו ו ע נ ע נ
דאווער	ד א ו ו ע ר
דאזאר	ד א ז א ר
דאזיגן	ד א ז י ג נ
דאזיגע	ד א ז י ג ע
דאזיגער	ד א ז י ג ע ר
דאטשע	ד א ט ש ע
דאך	ד א כ
דאכט	ד א כ ט
דאכטן	ד א כ ט נ
דאן	ד א נ
דאנען	ד א נ ע נ
דאנערשטאג	ד א נ ע ר ש ט א ג
דאנציג	ד א נ צ י ג
דאנק	ד א נ ק
דאנקבארקייט	ד א נ ק ב א ר ק י י ט
דאנקט	ד א נ ק ט
דאנקען	ד א נ ק ע נ
דאס	ד א ס
דאקטאר	ד א ק ט א ר
דאקטוירים	ד א ק ט ו י ר י מ
דאקטער	ד א ק ט ע ר
דאקטערס	ד א ק ט ע ר ס
דאר	ד א ר
דאר־	ד א ר
דארויס	ד א ר ו י ס
דארט	ד א ר ט
דארטן	ד א ר ט נ
דארן	ד א ר נ
דארס	ד א ר ס
דארע	ד א ר ע
דארער	ד א ר ע ר
דארף	ד א ר ף
דארפט	ד א ר פ ט
דארפישן	ד א ר פ י ש נ
דארפן	ד א ר פ נ
דארפסטו	ד א ר פ ס ט ו
דאשעק	ד א ש ע ק
דאשעקל	ד א ש ע ק ל
דבר	ד ב ר
דהיינו	ד ה י י נ ו
דו	ד ו
דוד	ד ו ד
דוד'ל	ד ו ד ל
דוד'לען	ד ו ד ל ע נ
דוואריעץ	ד ו ו א ר י ע צ
דויערן	ד ו י ע ר נ
דולן	ד ו ל נ
דולער	ד ו ל ע ר
דונער	ד ו נ ע ר
דופק	ד ו פ ק
דוצט	ד ו צ ט
דוקא	ד ו ק א
דור	ד ו ר
דורך	ד ו ר כ
דורכגיין	ד ו ר כ ג י י נ
דורכגייענדיג	ד ו ר כ ג י י ע נ ד י ג
דורכגייער	ד ו ר כ ג י י ע ר
דורכגעטריבענע	ד ו ר כ ג ע ט ר י ב ע נ ע
דורכגעפירט	ד ו ר כ ג ע פ י ר ט
דורכגעפלויגן	ד ו ר כ ג ע פ ל ו י ג נ
דורכגעשוועבט	ד ו ר כ ג ע ש ו ו ע ב ט
דורכגעשווענקט	ד ו ר כ ג ע ש ו ו ע נ ק ט
דורכזיכטיג	ד ו ר כ ז י כ ט י ג
דורכלאזן	ד ו ר כ ל א ז נ
דורכן	ד ו ר כ נ
דורכפארן	ד ו ר כ פ א ר נ
דורכרייזנדיג	ד ו ר כ ר י י ז נ ד י ג
דורכשלאג	ד ו ר כ ש ל א ג
דורס	ד ו ר ס
די	ד י
דיבור	ד י ב ו ר
דיבורים	ד י ב ו ר י מ
דיג	ד י ג
דיגע	ד י ג ע
דיגער	ד י ג ע ר
דייזשע	ד י י ז ש ע
דייטש	ד י י ט ש
דייטשיש	ד י י ט ש י ש
דייטשל	ד י י ט ש ל
דייטשלס	ד י י ט ש ל ס
דייטשמעריש	ד י י ט ש מ ע ר י ש
דייטשן	ד י י ט ש נ
דיין	ד י י נ
דיינים	ד י י נ י מ
דיינע	ד י י נ ע
דיינעם	ד י י נ ע מ
דייעט	ד י י ע ט
דיך	ד י כ
דימענט	ד י מ ע נ ט
דין	ד י נ
דין־וחשבון	ד י נ ו ח ש ב ו נ
דין־יונג	ד י נ י ו נ ג
דינגט	ד י נ ג ט
דינגען	ד י נ ג ע נ
דיני	ד י נ י
דיניטשקע	ד י נ י ט ש ק ע
דיניס	ד י נ י ס
דינסט	ד י נ ס ט
דינסטמיידל	ד י נ ס ט מ י י ד ל
דינסטן	ד י נ ס ט נ
דינסטס	ד י נ ס ט ס
דינע	ד י נ ע
דינעם	ד י נ ע מ
דיעלע	ד י ע ל ע
דיקדוק	ד י ק ד ו ק
דיקן	ד י ק נ
דיקסי	ד י ק ס י
דיר	ד י ר
דירה	ד י ר ה
דישל	ד י ש ל
דעה	ד ע ה
דעי	ד ע י
דעכל	ד ע כ ל
דעכער	ד ע כ ע ר
דעליקטו	ד ע ל י ק ט ו
דעם	ד ע מ
דעמאלט	ד ע מ א ל ט
דען	ד ע נ
דענסטמאל	ד ע נ ס ט מ א ל
דענצמאל	ד ע נ צ מ א ל
דענצמאלדיגע	ד ע נ צ מ א ל ד י ג ע
דענק	ד ע נ ק
דעק	ד ע ק
דעקט	ד ע ק ט
דעקלאמירט	ד ע ק ל א מ י ר ט
דעקן	ד ע ק נ
דעקע	ד ע ק ע
דער	ד ע ר
דער'הרג'עט	ד ע ר ה ר ג ע ט
דער־	ד ע ר
דערבארעמען	ד ע ר ב א ר ע מ ע נ
דערביי	ד ע ר ב י י
דערגאנגען	ד ע ר ג א נ ג ע נ
דערגייט	ד ע ר ג י י ט
דערגיין	ד ע ר ג י י נ
דערגיס	ד ע ר ג י ס
דערגיסט	ד ע ר ג י ס ט
דערגרונטעווען	ד ע ר ג ר ו נ ט ע ו ו ע נ
דערגרייכן	ד ע ר ג ר י י כ נ
דערהויבט	ד ע ר ה ו י ב ט
דערהויבן	ד ע ר ה ו י ב נ
דערהער	ד ע ר ה ע ר
דערהערט	ד ע ר ה ע ר ט
דערהערנדיג	ד ע ר ה ע ר נ ד י ג
דערוואוסט	ד ע ר ו ו א ו ס ט
דערוואקסענע	ד ע ר ו ו א ק ס ע נ ע
דערוואקסענעם	ד ע ר ו ו א ק ס ע נ ע מ
דערווארגן	ד ע ר ו ו א ר ג נ
דערווייטערט	ד ע ר ו ו י י ט ע ר ט
דערווייל	ד ע ר ו ו י י ל
דערוויילע	ד ע ר ו ו י י ל ע
דערוויסן	ד ע ר ו ו י ס נ
דערוועקט	ד ע ר ו ו ע ק ט
דערויף	ד ע ר ו י ף
דערונטער	ד ע ר ו נ ט ע ר
דערזעה	ד ע ר ז ע ה
דערזעהט	ד ע ר ז ע ה ט
דערזעהן	ד ע ר ז ע ה נ
דערזעהענדיג	ד ע ר ז ע ה ע נ ד י ג
דערטאפט	ד ע ר ט א פ ט
דערטרינקעניש	ד ע ר ט ר י נ ק ע נ י ש
דעריבער	ד ע ר י ב ע ר
דערינען	ד ע ר י נ ע נ
דערלאזט	ד ע ר ל א ז ט
דערלאזן	ד ע ר ל א ז נ
דערלאנגט	ד ע ר ל א נ ג ט
דערלאנגען	ד ע ר ל א נ ג ע נ
דערלאנגענדיג	ד ע ר ל א נ ג ע נ ד י ג
דערלויבן	ד ע ר ל ו י ב נ
דערלייג	ד ע ר ל י י ג
דערלייגט	ד ע ר ל י י ג ט
דערלייזונג	ד ע ר ל י י ז ו נ ג
דערלעבט	ד ע ר ל ע ב ט
דערלעבן	ד ע ר ל ע ב נ
דערמאן	ד ע ר מ א נ
דערמאנט	ד ע ר מ א נ ט
דערמאנען	ד ע ר מ א נ ע נ
דערמיט	ד ע ר מ י ט
דערנאך	ד ע ר נ א כ
דערנערט	ד ע ר נ ע ר ט
דערפאר	ד ע ר פ א ר
דערפארוואס	ד ע ר פ א ר ו ו א ס
דערפון	ד ע ר פ ו נ
דערפילט	ד ע ר פ י ל ט
דערפילן	ד ע ר פ י ל נ
דערפרישן	ד ע ר פ ר י ש נ
דערצו	ד ע ר צ ו
דערציטערטער	ד ע ר צ י ט ע ר ט ע ר
דערצייל	ד ע ר צ י י ל
דערציילונגען	ד ע ר צ י י ל ו נ ג ע נ
דערציילט	ד ע ר צ י י ל ט
דערציילן	ד ע ר צ י י ל נ
דערקאנט	ד ע ר ק א נ ט
דערקוויקעניש	ד ע ר ק ו ו י ק ע נ י ש
דערקוטשען	ד ע ר ק ו ט ש ע נ
דערקלער	ד ע ר ק ל ע ר
דערקלערט	ד ע ר ק ל ע ר ט
דערקען	ד ע ר ק ע נ
דערקענט	ד ע ר ק ע נ ט
דערקענען	ד ע ר ק ע נ ע נ
דערשטיגט	ד ע ר ש ט י ג ט
דערשלאגן	ד ע ר ש ל א ג נ
דערשמעקט	ד ע ר ש מ ע ק ט
דערשראקן	ד ע ר ש ר א ק נ
דערשראקענע	ד ע ר ש ר א ק ע נ ע
דערשראקענער	ד ע ר ש ר א ק ע נ ע ר
דערשרעקט	ד ע ר ש ר ע ק ט
דר'ערד	ד ר ע ר ד
דראט־ארבעטנדיגע	ד ר א ט א ר ב ע ט נ ד י ג ע
דראמאטישער	ד ר א מ א ט י ש ע ר
דראמען־שרייבער	ד ר א מ ע נ ש ר י י ב ע ר
דראנג	ד ר א נ ג
דראפעט	ד ר א פ ע ט
דראשקעס	ד ר א ש ק ע ס
דרויסן	ד ר ו י ס נ
דרוק	ד ר ו ק
דריטל	ד ר י ט ל
דריטן	ד ר י ט נ
דריטע	ד ר י ט ע
דריטער	ד ר י ט ע ר
דריי	ד ר י י
דריידל	ד ר י י ד ל
דרייט	ד ר י י ט
דרייסט	ד ר י י ס ט
דרייסטער	ד ר י י ס ט ע ר
דרייסיג	ד ר י י ס י ג
דרייסיג־פערציג	ד ר י י ס י ג פ ע ר צ י ג
דרייען	ד ר י י ע נ
דרייער	ד ר י י ע ר
דרייצן	ד ר י י צ נ
דרייצנטער	ד ר י י צ נ ט ע ר
דרימלען	ד ר י מ ל ע נ
דרינגט	ד ר י נ ג ט
דרינגען	ד ר י נ ג ע נ
דרינען	ד ר י נ ע נ
דריקט	ד ר י ק ט
דריקן	ד ר י ק נ
דרך־ארץ	ד ר כ א ר צ
דרך־ארצדיקער	ד ר כ א ר צ ד י ק ע ר
דרעמלט	ד ר ע מ ל ט
דרעמלען	ד ר ע מ ל ע נ
דרשה	ד ר ש ה
דרשות	ד ר ש ו ת
הא	ה א
האב	ה א ב
האבן	ה א ב נ
האבעהיימע	ה א ב ע ה י י מ ע
האבער	ה א ב ע ר
האבער־קינדער	ה א ב ע ר ק י נ ד ע ר
האדעווע	ה א ד ע ו ו ע
האדעוועט	ה א ד ע ו ו ע ט
האדעווען	ה א ד ע ו ו ע נ
האדראס	ה א ד ר א ס
האדרעס	ה א ד ר ע ס
האו	ה א ו
האוודא־	ה א ו ו ד א
האוילעם	ה א ו י ל ע מ
האט	ה א ט
האט'ן	ה א ט נ
האטס	ה א ט ס
האטעל	ה א ט ע ל
האייץ	ה א י י צ
האלב	ה א ל ב
האלב־געפרוירענעם	ה א ל ב ג ע פ ר ו י ר ע נ ע מ
האלב־ליטווישן	ה א ל ב ל י ט ו ו י ש נ
האלב־נאקעטע	ה א ל ב נ א ק ע ט ע
האלב־פארשלאסענע	ה א ל ב פ א ר ש ל א ס ע נ ע
האלבליך	ה א ל ב ל י כ
האלבן	ה א ל ב נ
האלבע	ה א ל ב ע
האלבער	ה א ל ב ע ר
האלדז	ה א ל ד ז
האלדזטיכל	ה א ל ד ז ט י כ ל
האלדזן	ה א ל ד ז נ
האלט	ה א ל ט
האלטן	ה א ל ט נ
האלטנדיג	ה א ל ט נ ד י ג
האלטסט	ה א ל ט ס ט
האלטסטו	ה א ל ט ס ט ו
האלץ	ה א ל צ
האלץ־האקן	ה א ל צ ה א ק נ
האלצגעשעפט	ה א ל צ ג ע ש ע פ ט
האמאאריוו	ה א מ א א ר י ו ו
האמייסע	ה א מ י י ס ע
האן	ה א נ
האנאר	ה א נ א ר
האנאריסטע	ה א נ א ר י ס ט ע
האנארעיבל	ה א נ א ר ע י ב ל
האנדל	ה א נ ד ל
האנדלט	ה א נ ד ל ט
האנדלען	ה א נ ד ל ע נ
האנט	ה א נ ט
האנטגעלט	ה א נ ט ג ע ל ט
האניג	ה א נ י ג
האס	ה א ס
האסט	ה א ס ט
האסטו	ה א ס ט ו
האסעניצע	ה א ס ע נ י צ ע
האסעניצעס	ה א ס ע נ י צ ע ס
האפ	ה א פ
האפן	ה א פ נ
האפענונג	ה א פ ע נ ו נ ג
האפערדיג	ה א פ ע ר ד י ג
האק	ה א ק
האקט	ה א ק ט
האקן	ה א ק נ
האקעס	ה א ק ע ס
האר	ה א ר
הארבן	ה א ר ב נ
הארט	ה א ר ט
הארטן	ה א ר ט נ
הארטע	ה א ר ט ע
הארטער	ה א ר ט ע ר
האריזאנט	ה א ר י ז א נ ט
הארכט	ה א ר כ ט
הארכן	ה א ר כ נ
הארמאט	ה א ר מ א ט
הארמאניע	ה א ר מ א נ י ע
הארמידער	ה א ר מ י ד ע ר
הארנשטיינס	ה א ר נ ש ט י י נ ס
הארעוועט	ה א ר ע ו ו ע ט
הארעווען	ה א ר ע ו ו ע נ
הארעפאשנעם	ה א ר ע פ א ש נ ע מ
הארפלאקס	ה א ר פ ל א ק ס
הארפע	ה א ר פ ע
הארץ	ה א ר צ
הארץ־ברעטלעך	ה א ר צ ב ר ע ט ל ע כ
הארץ־נאגנדע	ה א ר צ נ א ג נ ד ע
הארץ־סטרונעס	ה א ר צ ס ט ר ו נ ע ס
הארץ־קלאפן	ה א ר צ ק ל א פ נ
הארץ־רייסנדיגער	ה א ר צ ר י י ס נ ד י ג ע ר
הארציג	ה א ר צ י ג
הארצן	ה א ר צ נ
האשוויאי	ה א ש ו ו י א י
הבדלה	ה ב ד ל ה
הבדלה־וויין	ה ב ד ל ה ו ו י י נ
הגדה	ה ג ד ה
הגדול	ה ג ד ו ל
הגיבור	ה ג י ב ו ר
הו־הא	ה ו ה א
הוט	ה ו ט
הויב	ה ו י ב
הויבט	ה ו י ב ט
הויבן	ה ו י ב נ
הוידלקע	ה ו י ד ל ק ע
הוידעט	ה ו י ד ע ט
הוידען	ה ו י ד ע נ
הויז	ה ו י ז
הויזגעזינד	ה ו י ז ג ע ז י נ ד
הויזגעזינדן	ה ו י ז ג ע ז י נ ד נ
הויזל	ה ו י ז ל
הויזלעך	ה ו י ז ל ע כ
הויזן	ה ו י ז נ
הויזן־קעשענע	ה ו י ז נ ק ע ש ע נ ע
הויט	ה ו י ט
הויך	ה ו י כ
הויכן	ה ו י כ נ
הויכע	ה ו י כ ע
הויכער	ה ו י כ ע ר
הוילע	ה ו י ל ע
הויף	ה ו י ף
הויפדאמע	ה ו י פ ד א מ ע
הויפוועכטער	ה ו י פ ו ו ע כ ט ע ר
הויפטדאמע	ה ו י פ ט ד א מ ע
הויפן	ה ו י פ נ
הויפנס	ה ו י פ נ ס
הויקער	ה ו י ק ע ר
הולטיי	ה ו ל ט י י
הומאניטארע	ה ו מ א נ י ט א ר ע
הון	ה ו נ
הונגער	ה ו נ ג ע ר
הונגעריג	ה ו נ ג ע ר י ג
הונגערן	ה ו נ ג ע ר נ
הונדערט	ה ו נ ד ע ר ט
הונדערט־פראצענטיגער	ה ו נ ד ע ר ט פ ר א צ ע נ ט י ג ע ר
הונדערטער	ה ו נ ד ע ר ט ע ר
הונט	ה ו נ ט
הוסט	ה ו ס ט
הוסטן	ה ו ס ט נ
הוצאות	ה ו צ א ו ת
הורא	ה ו ר א
הוראה	ה ו ר א ה
הורטאווניקעס	ה ו ר ט א ו ו נ י ק ע ס
היגע	ה י ג ע
היוודאלטא	ה י ו ו ד א ל ט א
היוודאלעווען	ה י ו ו ד א ל ע ו ו ע נ
היום	ה י ו מ
היטל	ה י ט ל
היטלעך	ה י ט ל ע כ
היטלען	ה י ט ל ע נ
היטן	ה י ט נ
היטעלע	ה י ט ע ל ע
היטעלעך	ה י ט ע ל ע כ
היי	ה י י
הייב	ה י י ב
הייבט	ה י י ב ט
הייבן	ה י י ב נ
היידא	ה י י ד א
הייוון	ה י י ו ו נ
הייזל	ה י י ז ל
הייזליך	ה י י ז ל י כ
הייזלעך	ה י י ז ל ע כ
הייזער	ה י י ז ע ר
הייזעריג	ה י י ז ע ר י ג
הייזעריגן	ה י י ז ע ר י ג נ
הייזעריגע	ה י י ז ע ר י ג ע
הייטל	ה י י ט ל
הייל	ה י י ל
הייליג	ה י י ל י ג
הייליגן	ה י י ל י ג נ
הייליגע	ה י י ל י ג ע
הייליגער	ה י י ל י ג ע ר
היילן	ה י י ל נ
היים	ה י י מ
היימיש	ה י י מ י ש
היימישן	ה י י מ י ש נ
היימישע	ה י י מ י ש ע
היימישער	ה י י מ י ש ע ר
היימישקייט	ה י י מ י ש ק י י ט
היינט	ה י י נ ט
היינטיגן	ה י י נ ט י ג נ
היינטיגס	ה י י נ ט י ג ס
היינטיגע	ה י י נ ט י ג ע
היינטיגער	ה י י נ ט י ג ע ר
היינטמאדיש	ה י י נ ט מ א ד י ש
הייס	ה י י ס
הייס־אנגעזענגטע	ה י י ס א נ ג ע ז ע נ ג ט ע
הייסט	ה י י ס ט
הייסן	ה י י ס נ
הייסע	ה י י ס ע
הייסער	ה י י ס ע ר
היכ־	ה י כ
הילן	ה י ל נ
הילף	ה י ל ף
הילצערנע	ה י ל צ ע ר נ ע
הימל	ה י מ ל
הימלישע	ה י מ ל י ש ע
הימלען	ה י מ ל ע נ
הימעל־פאטער	ה י מ ע ל פ א ט ע ר
הינדל	ה י נ ד ל
הינדעלע	ה י נ ד ע ל ע
הינט	ה י נ ט
הינטישע	ה י נ ט י ש ע
הינטן	ה י נ ט נ
הינטעלעך	ה י נ ט ע ל ע כ
הינטער	ה י נ ט ע ר
הינטער־געסליך	ה י נ ט ע ר ג ע ס ל י כ
הינטער־קעשענע	ה י נ ט ע ר ק ע ש ע נ ע
הינטערגעסל	ה י נ ט ע ר ג ע ס ל
הינטערן	ה י נ ט ע ר נ
הינטערשטער	ה י נ ט ע ר ש ט ע ר
הינער	ה י נ ע ר
היפשע	ה י פ ש ע
היץ	ה י צ
הירשנביין	ה י ר ש נ ב י י נ
היתכן	ה י ת כ נ
הכלל	ה כ ל ל
הכנות	ה כ נ ו ת
הכנסה	ה כ נ ס ה
הכנסת־אורחים	ה כ נ ס ת א ו ר ח י מ
הכנעה	ה כ נ ע ה
הלוואי	ה ל ו ו א י
הללויה	ה ל ל ו י ה
הללויהס	ה ל ל ו י ה ס
המבדיל	ה מ ב ד י ל
המוציא	ה מ ו צ י א
המלך	ה מ ל כ
המנס	ה מ נ ס
המצאה	ה מ צ א ה
הנאה	ה נ א ה
הנביאס	ה נ ב י א ס
הסב־בעט	ה ס ב ב ע ט
הסכמה	ה ס כ מ ה
העדרעס	ה ע ד ר ע ס
העזה	ה ע ז ה
העט־העט	ה ע ט ה ע ט
העכט	ה ע כ ט
העכסט	ה ע כ ס ט
העכסטנס	ה ע כ ס ט נ ס
העכער	ה ע כ ע ר
העכערן	ה ע כ ע ר נ
העכערע	ה ע כ ע ר ע
העל	ה ע ל
העל־רויז	ה ע ל ר ו י ז
העל־רויטליך־בלוי־טונקל־גרין־פאפעליאטע	ה ע ל ר ו י ט ל י כ ב ל ו י ט ו נ ק ל ג ר י נ פ א פ ע ל י א ט ע
העלדזל	ה ע ל ד ז ל
העלדזער	ה ע ל ד ז ע ר
העליש	ה ע ל י ש
העלן	ה ע ל נ
העלף	ה ע ל ף
העלפט	ה ע ל פ ט
העלפן	ה ע ל פ נ
העלפנדיג	ה ע ל פ נ ד י ג
העלצלעך	ה ע ל צ ל ע כ
העם	ה ע מ
העמד	ה ע מ ד
העמדל	ה ע מ ד ל
הענגט	ה ע נ ג ט
הענגען	ה ע נ ג ע נ
הענגערל	ה ע נ ג ע ר ל
הענגקאלנער	ה ע נ ג ק א ל נ ע ר
הענדום־פענדום	ה ע נ ד ו מ פ ע נ ד ו מ
הענדל	ה ע נ ד ל
הענדלס	ה ע נ ד ל ס
הענדלען	ה ע נ ד ל ע נ
הענט	ה ע נ ט
הענטל	ה ע נ ט ל
הענטלעך	ה ע נ ט ל ע כ
הענעך	ה ע נ ע כ
הענרי	ה ע נ ר י
העפט	ה ע פ ט
העפטן	ה ע פ ט נ
העק	ה ע ק
העקער	ה ע ק ע ר
העקערס	ה ע ק ע ר ס
הער	ה ע ר
העראט	ה ע ר א ט
הערט	ה ע ר ט
הערינג	ה ע ר י נ ג
הערלעכע	ה ע ר ל ע כ ע
הערן	ה ע ר נ
הערנדיג	ה ע ר נ ד י ג
הערנער	ה ע ר נ ע ר
הערסט	ה ע ר ס ט
הערסטו	ה ע ר ס ט ו
הערצל	ה ע ר צ ל
הערצליכן	ה ע ר צ ל י כ נ
הערצער	ה ע ר צ ע ר
הערש־בער	ה ע ר ש ב ע ר
הערשל	ה ע ר ש ל
הקדוש־ברוך־הוא	ה ק ד ו ש ב ר ו כ ה ו א
הקדש	ה ק ד ש
הקפות	ה ק פ ו ת
הרג'עט	ה ר ג ע ט
הרובע	ה ר ו ב ע
הרוגים	ה ר ו ג י מ
הריגות	ה ר י ג ו ת
השגה	ה ש ג ה
השכלה	ה ש כ ל ה
השם־יתברך	ה ש מ י ת ב ר כ
התמדה	ה ת מ ד ה
התפעלות	ה ת פ ע ל ו ת
ובפרט	ו ב פ ר ט
והנורא	ו ה נ ו ר א
והשנית	ו ה ש נ י ת
ווא־	ו ו א
וואג	ו ו א ג
וואגאן	ו ו א ג א נ
וואגן	ו ו א ג נ
וואו	ו ו א ו
וואו־נישט־וואו	ו ו א ו נ י ש ט ו ו א ו
וואוהין	ו ו א ו ה י נ
וואויל	ו ו א ו י ל
וואוילטאן	ו ו א ו י ל ט א נ
וואוילן	ו ו א ו י ל נ
וואוילע	ו ו א ו י ל ע
וואוילער	ו ו א ו י ל ע ר
וואוילעשע	ו ו א ו י ל ע ש ע
וואוינט	ו ו א ו י נ ט
וואוינען	ו ו א ו י נ ע נ
וואונד	ו ו א ו נ ד
וואונדער	ו ו א ו נ ד ע ר
וואונדערבארן	ו ו א ו נ ד ע ר ב א ר נ
וואונדערט	ו ו א ו נ ד ע ר ט
וואונדערן	ו ו א ו נ ד ע ר נ
וואונק	ו ו א ו נ ק
וואוקס	ו ו א ו ק ס
וואייסראן	ו ו א י י ס ר א נ
וואייצמאך	ו ו א י י צ מ א כ
וואך	ו ו א כ
וואכן	ו ו א כ נ
וואכנטאג	ו ו א כ נ ט א ג
וואכעדיגן	ו ו א כ ע ד י ג נ
וואכעדיגע	ו ו א כ ע ד י ג ע
וואכעדיגער	ו ו א כ ע ד י ג ע ר
וואלאך	ו ו א ל א כ
וואלד	ו ו א ל ד
וואלוול	ו ו א ל ו ו ל
וואלט	ו ו א ל ט
וואלטן	ו ו א ל ט נ
וואלטסט	ו ו א ל ט ס ט
וואלטסטו	ו ו א ל ט ס ט ו
וואלף	ו ו א ל ף
וואלפל	ו ו א ל פ ל
וואלפן	ו ו א ל פ נ
וואלקן	ו ו א ל ק נ
וואלקנדליך	ו ו א ל ק נ ד ל י כ
וואלקנס	ו ו א ל ק נ ס
וואנ	ו ו א נ
וואנדערער	ו ו א נ ד ע ר ע ר
וואנדערערס	ו ו א נ ד ע ר ע ר ס
וואנט	ו ו א נ ט
וואנעט	ו ו א נ ע ט
וואנען	ו ו א נ ע נ
וואנצעס	ו ו א נ צ ע ס
וואס	ו ו א ס
וואס־זשע	ו ו א ס ז ש ע
וואסיל	ו ו א ס י ל
וואסער	ו ו א ס ע ר
וואסער־גיסן	ו ו א ס ע ר ג י ס נ
וואסער־גערויש	ו ו א ס ע ר ג ע ר ו י ש
וואסער־פירער	ו ו א ס ע ר פ י ר ע ר
וואסעריג	ו ו א ס ע ר י ג
וואסערן	ו ו א ס ע ר נ
וואסערע	ו ו א ס ע ר ע
וואסערפאל	ו ו א ס ע ר פ א ל
וואסערקינד	ו ו א ס ע ר ק י נ ד
וואסערשפראך	ו ו א ס ע ר ש פ ר א כ
וואספארא	ו ו א ס פ א ר א
וואספאראפנים	ו ו א ס פ א ר א פ נ י מ
וואקאציע	ו ו א ק א צ י ע
וואקס	ו ו א ק ס
וואקסט	ו ו א ק ס ט
וואקסן	ו ו א ק ס נ
וואר	ו ו א ר
ווארט	ו ו א ר ט
ווארטן	ו ו א ר ט נ
ווארטנדיג	ו ו א ר ט נ ד י ג
ווארע	ו ו א ר ע
ווארעם	ו ו א ר ע מ
ווארעמט	ו ו א ר ע מ ט
ווארעמס	ו ו א ר ע מ ס
ווארעמע	ו ו א ר ע מ ע
ווארעמען	ו ו א ר ע מ ע נ
ווארעמעס	ו ו א ר ע מ ע ס
ווארעמער	ו ו א ר ע מ ע ר
ווארעמקייט	ו ו א ר ע מ ק י י ט
ווארף	ו ו א ר ף
ווארפט	ו ו א ר פ ט
ווארפן	ו ו א ר פ נ
ווארצל	ו ו א ר צ ל
ווארצלען	ו ו א ר צ ל ע נ
ווארצעליך	ו ו א ר צ ע ל י כ
ווארשע	ו ו א ר ש ע
וואש	ו ו א ש
וואשט	ו ו א ש ט
וואשן	ו ו א ש נ
ווי	ו ו י
וויאזוי	ו ו י א ז ו י
וויארסט	ו ו י א ר ס ט
וויבאלד	ו ו י ב א ל ד
וויג	ו ו י ג
וויגט	ו ו י ג ט
וויגל	ו ו י ג ל
וויגן	ו ו י ג נ
ווידוי	ו ו י ד ו י
ווידער	ו ו י ד ע ר
ווידערקול	ו ו י ד ע ר ק ו ל
וויזיט	ו ו י ז י ט
וויטע	ו ו י ט ע
וויי	ו ו י י
וויי־וויי	ו ו י י ו ו י י
ווייב	ו ו י י ב
ווייבל	ו ו י י ב ל
ווייבלעך	ו ו י י ב ל ע כ
ווייבס	ו ו י י ב ס
ווייבער	ו ו י י ב ע ר
ווייבעריש	ו ו י י ב ע ר י ש
ווייבערישע	ו ו י י ב ע ר י ש ע
ווייבערישער	ו ו י י ב ע ר י ש ע ר
ווייבערשע	ו ו י י ב ע ר ש ע
ווייבערשער	ו ו י י ב ע ר ש ע ר
וויידל	ו ו י י ד ל
וויידליך	ו ו י י ד ל י כ
ווייז	ו ו י י ז
ווייזט	ו ו י י ז ט
ווייזן	ו ו י י ז נ
ווייט	ו ו י י ט
ווייט־ברענענדיגע	ו ו י י ט ב ר ע נ ע נ ד י ג ע
ווייטן	ו ו י י ט נ
ווייטנס	ו ו י י ט נ ס
ווייטער	ו ו י י ט ע ר
ווייך	ו ו י י כ
ווייכן	ו ו י י כ נ
ווייכע	ו ו י י כ ע
ווייכער	ו ו י י כ ע ר
ווייל	ו ו י י ל
וויילע	ו ו י י ל ע
וויין	ו ו י י נ
וויינגארטן	ו ו י י נ ג א ר ט נ
וויינט	ו ו י י נ ט
וויינטרויבן	ו ו י י נ ט ר ו י ב נ
ווייניג	ו ו י י נ י ג
ווייניגע	ו ו י י נ י ג ע
וויינען	ו ו י י נ ע נ
וויינענדיג	ו ו י י נ ע נ ד י ג
וויינענדיגן	ו ו י י נ ע נ ד י ג נ
וויינענדיגע	ו ו י י נ ע נ ד י ג ע
וויינפערל	ו ו י י נ פ ע ר ל
וויינפערלעך	ו ו י י נ פ ע ר ל ע כ
וויינשל	ו ו י י נ ש ל
וויינשעלעך	ו ו י י נ ש ע ל ע כ
ווייס	ו ו י י ס
ווייסט	ו ו י י ס ט
ווייסטו	ו ו י י ס ט ו
ווייסל	ו ו י י ס ל
ווייסן	ו ו י י ס נ
ווייסע	ו ו י י ס ע
ווייסער	ו ו י י ס ע ר
ווייסקייט	ו ו י י ס ק י י ט
ווייעט	ו ו י י ע ט
ווייען	ו ו י י ע נ
ווייץ	ו ו י י צ
ווייצליך	ו ו י י צ ל י כ
וויכטיגן	ו ו י כ ט י ג נ
וויל	ו ו י ל
ווילד	ו ו י ל ד
ווילד־פרעמדער	ו ו י ל ד פ ר ע מ ד ע ר
ווילדע	ו ו י ל ד ע
ווילדער	ו ו י ל ד ע ר
ווילט	ו ו י ל ט
ווילן	ו ו י ל נ
ווילנדיג	ו ו י ל נ ד י ג
ווילסט	ו ו י ל ס ט
ווילסטו	ו ו י ל ס ט ו
ווילעדזש	ו ו י ל ע ד ז ש
ווילעדזש־אידן	ו ו י ל ע ד ז ש א י ד נ
ווימאראזיג	ו ו י מ א ר א ז י ג
ווינד	ו ו י נ ד
ווינט	ו ו י נ ט
ווינטל	ו ו י נ ט ל
ווינטן	ו ו י נ ט נ
ווינטס	ו ו י נ ט ס
ווינטער	ו ו י נ ט ע ר
ווינטערדיג	ו ו י נ ט ע ר ד י ג
ווינטערדיגן	ו ו י נ ט ע ר ד י ג נ
ווינטערדיגע	ו ו י נ ט ע ר ד י ג ע
ווינטערלאמפ	ו ו י נ ט ע ר ל א מ פ
ווינטערנאכט	ו ו י נ ט ע ר נ א כ ט
ווינטערצייט	ו ו י נ ט ע ר צ י י ט
ווינטש	ו ו י נ ט ש
ווינטשט	ו ו י נ ט ש ט
ווינטשן	ו ו י נ ט ש נ
ווינטשעוועט	ו ו י נ ט ש ע ו ו ע ט
ווינציג	ו ו י נ צ י ג
ווינציג־וואס	ו ו י נ צ י ג ו ו א ס
ווינציגער	ו ו י נ צ י ג ע ר
ווינקט	ו ו י נ ק ט
ווינקל	ו ו י נ ק ל
ווינקלנעזער	ו ו י נ ק ל נ ע ז ע ר
ווינקעלע	ו ו י נ ק ע ל ע
ווינקען	ו ו י נ ק ע נ
וויסטע	ו ו י ס ט ע
וויסן	ו ו י ס נ
וויסנדיג	ו ו י ס נ ד י ג
וויפיל	ו ו י פ י ל
וויץ	ו ו י צ
וויקלען	ו ו י ק ל ע נ
וויראבאווא	ו ו י ר א ב א ו ו א
ווירע	ו ו י ר ע
ווירקליך	ו ו י ר ק ל י כ
וויש	ו ו י ש
ווישט	ו ו י ש ט
ווישניג	ו ו י ש נ י ג
וועג	ו ו ע ג
וועגט	ו ו ע ג ט
וועגן	ו ו ע ג נ
וועדליג	ו ו ע ד ל י ג
וועהאקאלע	ו ו ע ה א ק א ל ע
וועהו־ראכום	ו ו ע ה ו ר א כ ו מ
וועהויע	ו ו ע ה ו י ע
וועהיוודאלטא	ו ו ע ה י ו ו ד א ל ט א
וועהיוודאלטעס	ו ו ע ה י ו ו ד א ל ט ע ס
וועט	ו ו ע ט
וועטאמליכו	ו ו ע ט א מ ל י כ ו
וועטשערע	ו ו ע ט ש ע ר ע
וועייסקאדאש	ו ו ע י י ס ק א ד א ש
וועכאצי	ו ו ע כ א צ י
וועכטער	ו ו ע כ ט ע ר
וועל	ו ו ע ל
וועלדל	ו ו ע ל ד ל
וועלדער	ו ו ע ל ד ע ר
וועלוול	ו ו ע ל ו ו ל
וועלוועלער	ו ו ע ל ו ו ע ל ע ר
וועלוי	ו ו ע ל ו י
וועלט	ו ו ע ל ט
וועלטל	ו ו ע ל ט ל
וועלטן	ו ו ע ל ט נ
וועלכן	ו ו ע ל כ נ
וועלכע	ו ו ע ל כ ע
וועלכעס	ו ו ע ל כ ע ס
וועלכער	ו ו ע ל כ ע ר
וועלן	ו ו ע ל נ
וועלנדיג	ו ו ע ל נ ד י ג
וועלף	ו ו ע ל ף
וועמען	ו ו ע מ ע נ
וועמענס	ו ו ע מ ע נ ס
וועמעס	ו ו ע מ ע ס
ווען	ו ו ע נ
ווען־נישט־ווען	ו ו ע נ נ י ש ט ו ו ע נ
ווענדט	ו ו ע נ ד ט
ווענט	ו ו ע נ ט
וועסט	ו ו ע ס ט
וועסטו	ו ו ע ס ט ו
וועסנע	ו ו ע ס נ ע
וועעט	ו ו ע ע ט
וועעס	ו ו ע ע ס
וועקידאלטא	ו ו ע ק י ד א ל ט א
וועקידאשטא	ו ו ע ק י ד א ש ט א
וועקן	ו ו ע ק נ
וועקסל	ו ו ע ק ס ל
וועקסלען	ו ו ע ק ס ל ע נ
ווער	ו ו ע ר
ווער־וואס	ו ו ע ר ו ו א ס
ווערט	ו ו ע ר ט
ווערטלעך	ו ו ע ר ט ל ע כ
ווערטעלע	ו ו ע ר ט ע ל ע
ווערטער	ו ו ע ר ט ע ר
ווערי	ו ו ע ר י
ווערן	ו ו ע ר נ
ווערסט	ו ו ע ר ס ט
ווערעם	ו ו ע ר ע מ
ווערעמדיגס	ו ו ע ר ע מ ד י ג ס
ווערצליך	ו ו ע ר צ ל י כ
ווערצעליך	ו ו ע ר צ ע ל י כ
ווערק	ו ו ע ר ק
וועש	ו ו ע ש
וועשאל	ו ו ע ש א ל
וועשואווי	ו ו ע ש ו א ו ו י
וועשואווע	ו ו ע ש ו א ו ו ע
וועשיראסא	ו ו ע ש י ר א ס א
ויהי	ו י ה י
ונאמר	ו נ א מ ר
ושתי	ו ש ת י
ושתין	ו ש ת י נ
זאג	ז א ג
זאגט	ז א ג ט
זאגן	ז א ג נ
זאגנדיג	ז א ג נ ד י ג
זאטלט	ז א ט ל ט
זאך	ז א כ
זאכן	ז א כ נ
זאכענישן	ז א כ ע נ י ש נ
זאל	ז א ל
זאלט	ז א ל ט
זאלן	ז א ל נ
זאלסט	ז א ל ס ט
זאלסטו	ז א ל ס ט ו
זאלץ	ז א ל צ
זאלצמעסטל	ז א ל צ מ ע ס ט ל
זאמד	ז א מ ד
זאמלביכער	ז א מ ל ב י כ ע ר
זאניטעצע	ז א נ י ט ע צ ע
זאפאני־בראטא	ז א פ א נ י ב ר א ט א
זאפרען	ז א פ ר ע נ
זאץ	ז א צ
זאק	ז א ק
זאקן	ז א ק נ
זאקן־בענדל	ז א ק נ ב ע נ ד ל
זארגט	ז א ר ג ט
זארגן	ז א ר ג נ
זודיגן	ז ו ד י ג נ
זויגן	ז ו י ג נ
זויגנדיגע	ז ו י ג נ ד י ג ע
זוילן	ז ו י ל נ
זוימען	ז ו י מ ע נ
זויער	ז ו י ע ר
זויערטייג	ז ו י ע ר ט י י ג
זויערס	ז ו י ע ר ס
זויערע	ז ו י ע ר ע
זויערער	ז ו י ע ר ע ר
זויפנדיג	ז ו י פ נ ד י ג
זוכה	ז ו כ ה
זוכט	ז ו כ ט
זוכן	ז ו כ נ
זוכסטו	ז ו כ ס ט ו
זול	ז ו ל
זולצערס	ז ו ל צ ע ר ס
זום־זום־זום	ז ו מ ז ו מ ז ו מ
זומער	ז ו מ ע ר
זומער־לעבן	ז ו מ ע ר ל ע ב נ
זומערדיגע	ז ו מ ע ר ד י ג ע
זומערטאג	ז ו מ ע ר ט א ג
זומערצייט	ז ו מ ע ר צ י י ט
זומפ	ז ו מ פ
זומפן	ז ו מ פ נ
זון	ז ו נ
זונס	ז ו נ ס
זוסמאנס	ז ו ס מ א נ ס
זופט	ז ו פ ט
זי	ז י
זיבן	ז י ב נ
זיבן־קאנטיג	ז י ב נ ק א נ ט י ג
זיבעצן	ז י ב ע צ נ
זיד	ז י ד
זידלט	ז י ד ל ט
זידלען	ז י ד ל ע נ
זיווג	ז י ו ו ג
זיי	ז י י
זייגער	ז י י ג ע ר
זייגער־מאכער	ז י י ג ע ר מ א כ ע ר
זייגערס	ז י י ג ע ר ס
זיידל	ז י י ד ל
זיידן	ז י י ד נ
זיידע	ז י י ד ע
זיידעניו	ז י י ד ע נ י ו
זיידענע	ז י י ד ע נ ע
זיידענעם	ז י י ד ע נ ע מ
זיידענער	ז י י ד ע נ ע ר
זיידעשי	ז י י ד ע ש י
זייט	ז י י ט
זייט־מיר־מוחל	ז י י ט מ י ר מ ו ח ל
זייטוועג	ז י י ט ו ו ע ג
זייטיגע	ז י י ט י ג ע
זייטן	ז י י ט נ
זייכער	ז י י כ ע ר
זיילן	ז י י ל נ
זיין	ז י י נ
זייניגע	ז י י נ י ג ע
זיינס	ז י י נ ס
זיינע	ז י י נ ע
זיינער	ז י י נ ע ר
זייעט	ז י י ע ט
זייער	ז י י ע ר
זייער־זייער	ז י י ע ר ז י י ע ר
זייערט	ז י י ע ר ט
זייעריגע	ז י י ע ר י ג ע
זייערן	ז י י ע ר נ
זייערס	ז י י ע ר ס
זייערע	ז י י ע ר ע
זייערער	ז י י ע ר ע ר
זייף	ז י י ף
זיך	ז י כ
זיכער	ז י כ ע ר
זיכערן	ז י כ ע ר נ
זיכערע	ז י כ ע ר ע
זיכערער	ז י כ ע ר ע ר
זילבערנע	ז י ל ב ע ר נ ע
זילבערנעם	ז י ל ב ע ר נ ע מ
זילבערנער	ז י ל ב ע ר נ ע ר
זין	ז י נ
זינג	ז י נ ג
זינגט	ז י נ ג ט
זינגען	ז י נ ג ע נ
זינגענדיג	ז י נ ג ע נ ד י ג
זינגערליך	ז י נ ג ע ר ל י כ
זינד	ז י נ ד
זינט	ז י נ ט
זינען	ז י נ ע נ
זינקט	ז י נ ק ט
זיס	ז י ס
זיסן	ז י ס נ
זיסע	ז י ס ע
זיסער	ז י ס ע ר
זיסקייט	ז י ס ק י י ט
זיפצט	ז י פ צ ט
זיפצסט	ז י פ צ ס ט
זיץ	ז י צ
זיצט	ז י צ ט
זיצן	ז י צ נ
זיצנדיג	ז י צ נ ד י ג
זכות־אבות	ז כ ו ת א ב ו ת
זכיה	ז כ י ה
זכר	ז כ ר
זכרון	ז כ ר ו נ
זכרונו	ז כ ר ו נ ו
זלאדי	ז ל א ד י
זלאדיעווקע	ז ל א ד י ע ו ו ק ע
זמן־כערוסיינו	ז מ נ כ ע ר ו ס י י נ ו
זמן־שמחתנו	ז מ נ ש מ ח ת נ ו
זמר	ז מ ר
זעה	ז ע ה
זעהט	ז ע ה ט
זעהן	ז ע ה נ
זעהסט	ז ע ה ס ט
זעהסטו	ז ע ה ס ט ו
זעהען	ז ע ה ע נ
זעהענדיג	ז ע ה ע נ ד י ג
זעכציג	ז ע כ צ י ג
זעכצן	ז ע כ צ נ
זעלביגן	ז ע ל ב י ג נ
זעלבן	ז ע ל ב נ
זעלבסטפארשטענדליך	ז ע ל ב ס ט פ א ר ש ט ע נ ד ל י כ
זעלבע	ז ע ל ב ע
זעלבער	ז ע ל ב ע ר
זעלטן־זעלטן	ז ע ל ט נ ז ע ל ט נ
זעלטענע	ז ע ל ט ע נ ע
זעלנער	ז ע ל נ ע ר
זעלנערישן	ז ע ל נ ע ר י ש נ
זעלנערישע	ז ע ל נ ע ר י ש ע
זעמל	ז ע מ ל
זענען	ז ע נ ע נ
זעץ	ז ע צ
זעצט	ז ע צ ט
זעצן	ז ע צ נ
זעק	ז ע ק
זעקל	ז ע ק ל
זעקלעך	ז ע ק ל ע כ
זעקס	ז ע ק ס
זעקס־און־זיבעציג	ז ע ק ס א ו נ ז י ב ע צ י ג
זעקסטן	ז ע ק ס ט נ
זר'חן	ז ר ח נ
זשאבעס	ז ש א ב ע ס
זשאבקעלעך	ז ש א ב ק ע ל ע כ
זשאלעווען	ז ש א ל ע ו ו ע נ
זשומען	ז ש ו מ ע נ
זשילעט	ז ש י ל ע ט
זשימנע	ז ש י מ נ ע
זשמוט	ז ש מ ו ט
זשע	ז ש ע
זשעדנע	ז ש ע ד נ ע
חבר	ח ב ר
חבר'ה	ח ב ר ה
חבר'ה־מאן	ח ב ר ה מ א נ
חבר'ה־מענטשן	ח ב ר ה מ ע נ ט ש נ
חבר'ט	ח ב ר ט
חבר'טארינס	ח ב ר ט א ר י נ ס
חבר'ן	ח ב ר נ
חברים	ח ב ר י מ
חדר	ח ד ר
חדר־אינגל	ח ד ר א י נ ג ל
חדר־אינגלעך	ח ד ר א י נ ג ל ע כ
חדר־אינגעלע	ח ד ר א י נ ג ע ל ע
חוב	ח ו ב
חובות	ח ו ב ו ת
חודש	ח ו ד ש
חול־המועד	ח ו ל ה מ ו ע ד
חול־המועדיגן	ח ו ל ה מ ו ע ד י ג נ
חולה	ח ו ל ה
חולין	ח ו ל י נ
חומש	ח ו מ ש
חומשים	ח ו מ ש י מ
חופה	ח ו פ ה
חוץ	ח ו צ
חוץ־לדרך־הטבע	ח ו צ ל ד ר כ ה ט ב ע
חוקר־ודורש	ח ו ק ר ו ד ו ר ש
חורבה	ח ו ר ב ה
חורבות	ח ו ר ב ו ת
חורבן	ח ו ר ב נ
חושד	ח ו ש ד
חושך	ח ו ש כ
חזיר	ח ז י ר
חזיר'ישן	ח ז י ר י ש נ
חזירים	ח ז י ר י מ
חזירים'לעך	ח ז י ר י מ ל ע כ
חזן	ח ז נ
חזן'ס	ח ז נ ס
חזנים	ח ז נ י מ
חזקה	ח ז ק ה
חזר	ח ז ר
חזר'ט	ח ז ר ט
חזר'ת־השץ	ח ז ר ת ה ש צ
חי	ח י
חי־וקים	ח י ו ק י מ
חידוש	ח י ד ו ש
חידוש־טרעפער	ח י ד ו ש ט ר ע פ ע ר
חידושים	ח י ד ו ש י מ
חיה	ח י ה
חיונה	ח י ו נ ה
חיות	ח י ו ת
חיים	ח י י מ
חיים־חנא	ח י י מ ח נ א
חיימטע	ח י י מ ט ע
חיימס	ח י י מ ס
חיימען	ח י י מ ע נ
חילוף	ח י ל ו ף
חילוק	ח י ל ו ק
חכם	ח כ מ
חכמה	ח כ מ ה
חכמים	ח כ מ י מ
חכמת־הדאקטאריע	ח כ מ ת ה ד א ק ט א ר י ע
חכמת־החשבון	ח כ מ ת ה ח ש ב ו נ
חלב	ח ל ב
חלה	ח ל ה
חלום	ח ל ו מ
חלומות	ח ל ו מ ו ת
חלילה	ח ל י ל ה
חלק	ח ל ק
חלשט	ח ל ש ט
חלשן	ח ל ש נ
חן	ח נ
חנה	ח נ ה
חנה־שרה'לעס	ח נ ה ש ר ה ל ע ס
חנהן	ח נ ה נ
חנוכה	ח נ ו כ ה
חנוכה־לעמפלעך	ח נ ו כ ה ל ע מ פ ל ע כ
חניפה	ח נ י פ ה
חניפהליך	ח נ י פ ה ל י כ
חנעוודיג	ח נ ע ו ו ד י ג
חס־ושלום	ח ס ו ש ל ו מ
חסד	ח ס ד
חסיד	ח ס י ד
חסיד'יש־נגידיש	ח ס י ד י ש נ ג י ד י ש
חסיד'ישער	ח ס י ד י ש ע ר
חסידים	ח ס י ד י מ
חסר	ח ס ר
חסר־דעה	ח ס ר ד ע ה
חסרון	ח ס ר ו נ
חסרונות	ח ס ר ו נ ו ת
חפצים	ח פ צ י מ
חצי	ח צ י
חצי־אלול	ח צ י א ל ו ל
חצי־אלולדיג	ח צ י א ל ו ל ד י ג
חקירה־ספרים	ח ק י ר ה ס פ ר י מ
חקרן	ח ק ר נ
חרוב	ח ר ו ב
חרטה	ח ר ט ה
חרפה	ח ר פ ה
חרפות	ח ר פ ו ת
חשבון	ח ש ב ו נ
חשבונות	ח ש ב ו נ ו ת
חשבונען	ח ש ב ו נ ע נ
חשד	ח ש ד
חשוב'ן	ח ש ו ב נ
חשק	ח ש ק
חתונה	ח ת ו נ ה
חתונות	ח ת ו נ ו ת
חתמ'עט	ח ת מ ע ט
חתן	ח ת נ
חתן־כלה	ח ת נ כ ל ה
חתנס	ח ת נ ס
ט'וויל	ט ו ו י ל
טא	ט א
טאג	ט א ג
טאגט	ט א ג ט
טאוול	ט א ו ו ל
טאטן	ט א ט נ
טאטנס	ט א ט נ ס
טאטע	ט א ט ע
טאטע־מאמע	ט א ט ע מ א מ ע
טאטעס	ט א ט ע ס
טאטער	ט א ט ע ר
טאטעשי	ט א ט ע ש י
טאכטער	ט א כ ט ע ר
טאכטערס	ט א כ ט ע ר ס
טאכעס	ט א כ ע ס
טאל	ט א ל
טאלאטשינאווס	ט א ל א ט ש י נ א ו ו ס
טאליע	ט א ל י ע
טאמער	ט א מ ע ר
טאנעס	ט א נ ע ס
טאנץ	ט א נ צ
טאנצט	ט א נ צ ט
טאנצן	ט א נ צ נ
טאפ	ט א פ
טאפאלן	ט א פ א ל נ
טאפאלן־בוימער	ט א פ א ל נ ב ו י מ ע ר
טאפאלן־צווייגן	ט א פ א ל נ צ ו ו י י ג נ
טאפל	ט א פ ל
טאפלע	ט א פ ל ע
טאפן	ט א פ נ
טאפסט	ט א פ ס ט
טאקט	ט א ק ט
טאקסע	ט א ק ס ע
טאקע	ט א ק ע
טאר	ט א ר
טאראקאנעס	ט א ר א ק א נ ע ס
טארבעס	ט א ר ב ע ס
טארגעס	ט א ר ג ע ס
טארטן	ט א ר ט נ
טארסטו	ט א ר ס ט ו
טארעראם	ט א ר ע ר א מ
טאשמעס	ט א ש מ ע ס
טבע	ט ב ע
טו	ט ו
טובה	ט ו ב ה
טוביה	ט ו ב י ה
טוביהן	ט ו ב י ה נ
טובל	ט ו ב ל
טוהן	ט ו ה נ
טוואן	ט ו ו א נ
טוט	ט ו ט
טויב	ט ו י ב
טויבן	ט ו י ב נ
טויבער	ט ו י ב ע ר
טויג	ט ו י ג
טויוואלקן	ט ו י ו ו א ל ק נ
טויזנט	ט ו י ז נ ט
טויט	ט ו י ט
טויטן	ט ו י ט נ
טויטן־שטיבל	ט ו י ט נ ש ט י ב ל
טויטע	ט ו י ט ע
טוינעפל	ט ו י נ ע פ ל
טויער	ט ו י ע ר
טויערן	ט ו י ע ר נ
טוישט	ט ו י ש ט
טוישן	ט ו י ש נ
טוכלע	ט ו כ ל ע
טוליעט	ט ו ל י ע ט
טוליען	ט ו ל י ע נ
טומל	ט ו מ ל
טומפיגן	ט ו מ פ י ג נ
טון	ט ו נ
טונען	ט ו נ ע נ
טונק	ט ו נ ק
טונקל	ט ו נ ק ל
טונקל־טרויעריגע	ט ו נ ק ל ט ר ו י ע ר י ג ע
טונקעלן	ט ו נ ק ע ל נ
טונקעלע	ט ו נ ק ע ל ע
טונקעלער	ט ו נ ק ע ל ע ר
טוסטו	ט ו ס ט ו
טועה	ט ו ע ה
טוען	ט ו ע נ
טוץ	ט ו צ
טוקן	ט ו ק נ
טורמע	ט ו ר מ ע
טושבעכאסא	ט ו ש ב ע כ א ס א
טיטון	ט י ט ו נ
טיטל	ט י ט ל
טיטשקע	ט י ט ש ק ע
טיי	ט י י
טייבל	ט י י ב ל
טייג	ט י י ג
טייגל	ט י י ג ל
טייטלט	ט י י ט ל ט
טייך	ט י י כ
טייכל	ט י י כ ל
טייכס	ט י י כ ס
טייל	ט י י ל
טיילט	ט י י ל ט
טיילמאל	ט י י ל מ א ל
טיילן	ט י י ל נ
טייער	ט י י ע ר
טייערן	ט י י ע ר נ
טייערסטע	ט י י ע ר ס ט ע
טייערע	ט י י ע ר ע
טייערער	ט י י ע ר ע ר
טיכל	ט י כ ל
טיכלעך	ט י כ ל ע כ
טיכער־שטאף	ט י כ ע ר ש ט א ף
טינט	ט י נ ט
טינטן	ט י נ ט נ
טיף	ט י ף
טיפן	ט י פ נ
טיפע	ט י פ ע
טיפעניש	ט י פ ע נ י ש
טיפער	ט י פ ע ר
טיפער־טיפער	ט י פ ע ר ט י פ ע ר
טיפש	ט י פ ש
טיקא	ט י ק א
טיר	ט י ר
טירן	ט י ר נ
טיש	ט י ש
טישא	ט י ש א
טישטעך	ט י ש ט ע כ
טישטשע	ט י ש ט ש ע
טישל	ט י ש ל
טלית	ט ל י ת
טמא	ט מ א
טעאטער	ט ע א ט ע ר
טעאטער־דירעקטאר	ט ע א ט ע ר ד י ר ע ק ט א ר
טעג	ט ע ג
טעות	ט ע ו ת
טעכטער	ט ע כ ט ע ר
טעכטערל	ט ע כ ט ע ר ל
טעלער	ט ע ל ע ר
טעם	ט ע מ
טעמים	ט ע מ י מ
טעמפל	ט ע מ פ ל
טעמפעלע	ט ע מ פ ע ל ע
טענהט	ט ע נ ה ט
טענהן	ט ע נ ה נ
טענות	ט ע נ ו ת
טענער	ט ע נ ע ר
טענצל	ט ע נ צ ל
טעפ	ט ע פ
טעפל	ט ע פ ל
טעפלעך	ט ע פ ל ע כ
טעצל	ט ע צ ל
טעקסט	ט ע ק ס ט
טערקיי	ט ע ר ק י י
טפו	ט פ ו
טפחים	ט פ ח י מ
טפרוסס	ט פ ר ו ס ס
טראג	ט ר א ג
טראגט	ט ר א ג ט
טראגן	ט ר א ג נ
טראגנדיג	ט ר א ג נ ד י ג
טראגסט	ט ר א ג ס ט
טראגעדיג	ט ר א ג ע ד י ג
טראט	ט ר א ט
טראטוארן	ט ר א ט ו א ר נ
טראטווע	ט ר א ט ו ו ע
טראטוועס	ט ר א ט ו ו ע ס
טראך	ט ר א כ
טראכט	ט ר א כ ט
טראכטן	ט ר א כ ט נ
טראמוויי	ט ר א מ ו ו י י
טראמווייס	ט ר א מ ו ו י י ס
טראנספארט	ט ר א נ ס פ א ר ט
טראפן	ט ר א פ נ
טראפנס	ט ר א פ נ ס
טראץ	ט ר א צ
טראק	ט ר א ק
טרויערדיגן	ט ר ו י ע ר ד י ג נ
טרויערט	ט ר ו י ע ר ט
טרויעריג	ט ר ו י ע ר י ג
טרויעריג־ליבער	ט ר ו י ע ר י ג ל י ב ע ר
טרויעריגע	ט ר ו י ע ר י ג ע
טרויעריגער	ט ר ו י ע ר י ג ע ר
טרויערסט	ט ר ו י ע ר ס ט
טרונק	ט ר ו נ ק
טרופע	ט ר ו פ ע
טרוקן	ט ר ו ק נ
טרוקענע	ט ר ו ק ע נ ע
טרוקענער	ט ר ו ק ע נ ע ר
טריט	ט ר י ט
טרייבט	ט ר י י ב ט
טרייסט	ט ר י י ס ט
טרייסטן	ט ר י י ס ט נ
טרייסל	ט ר י י ס ל
טרייסלט	ט ר י י ס ל ט
טרייסלען	ט ר י י ס ל ע נ
טרינק	ט ר י נ ק
טרינקט	ט ר י נ ק ט
טרינקען	ט ר י נ ק ע נ
טריסק	ט ר י ס ק
טריסקער	ט ר י ס ק ע ר
טריפה	ט ר י פ ה
טריפן	ט ר י פ נ
טרעט	ט ר ע ט
טרענען	ט ר ע נ ע נ
טרעף	ט ר ע ף
טרעפ	ט ר ע פ
טרעפט	ט ר ע פ ט
טרעפלעך	ט ר ע פ ל ע כ
טרעפן	ט ר ע פ נ
טרעפנדיג	ט ר ע פ נ ד י ג
טרער	ט ר ע ר
טרערן	ט ר ע ר נ
טרפה	ט ר פ ה
טשוואק	ט ש ו ו א ק
טשוירטש	ט ש ו י ר ט ש
טשיקאווע	ט ש י ק א ו ו ע
טשעמאדאנטשיק	ט ש ע מ א ד א נ ט ש י ק
טשעפעט	ט ש ע פ ע ט
טשעפען	ט ש ע פ ע נ
טשערנאבילסקיס	ט ש ע ר נ א ב י ל ס ק י ס
טשערנאהוז	ט ש ע ר נ א ה ו ז
טשערקינעס	ט ש ע ר ק י נ ע ס
יא	י א
יאג	י א ג
יאגט	י א ג ט
יאגן	י א ג נ
יאגנדיגע	י א ג נ ד י ג ע
יאדייע־סויפער	י א ד י י ע ס ו י פ ע ר
יאכשי	י א כ ש י
יאלד	י א ל ד
יאם	י א מ
יאמים	י א מ י מ
יאמערן	י א מ ע ר נ
יאנאשעץ	י א נ א ש ע צ
יאסיע	י א ס י ע
יאסל	י א ס ל
יאסעפל	י א ס ע פ ל
יאר	י א ר
יאר־רעכענונג	י א ר ר ע כ ע נ ו נ ג
יאריד	י א ר י ד
יארמלקע	י א ר מ ל ק ע
יארן	י א ר נ
יד	י ד
יד־אחת	י ד א ח ת
יו	י ו
יובל	י ו ב ל
יוגנט	י ו ג נ ט
יודאפאב	י ו ד א פ א ב
יודל	י ו ד ל
יודלס	י ו ד ל ס
יודלען	י ו ד ל ע נ
יודנס	י ו ד נ ס
יודעלע	י ו ד ע ל ע
יוון	י ו ו נ
יויך	י ו י כ
יוים	י ו י מ
יויעשדיגן	י ו י ע ש ד י ג נ
יוכט	י ו כ ט
יום־ולילה	י ו מ ו ל י ל ה
יום־טוב	י ו מ ט ו ב
יום־טובדיג	י ו מ ט ו ב ד י ג
יום־טובדיגן	י ו מ ט ו ב ד י ג נ
יום־טובדיגע	י ו מ ט ו ב ד י ג ע
יום־טובדיגער	י ו מ ט ו ב ד י ג ע ר
יום־טובים	י ו מ ט ו ב י מ
יום־כיפור	י ו מ כ י פ ו ר
יום־כיפור־קטן	י ו מ כ י פ ו ר ק ט נ
יונג	י ו נ ג
יונג־בלוטיג	י ו נ ג ב ל ו ט י ג
יונגאטש	י ו נ ג א ט ש
יונגיטשקער	י ו נ ג י ט ש ק ע ר
יונגע	י ו נ ג ע
יונגע־לייט	י ו נ ג ע ל י י ט
יונגע־מאנטשיקלעך	י ו נ ג ע מ א נ ט ש י ק ל ע כ
יונגעטשקע	י ו נ ג ע ט ש ק ע
יונגען	י ו נ ג ע נ
יונגער	י ו נ ג ע ר
יונגער־מאן	י ו נ ג ע ר מ א נ
יונה	י ו נ ה
יוסף	י ו ס ף
יוצא־מן־הכלל	י ו צ א מ נ ה כ ל ל
יוראפ	י ו ר א פ
יורה־דעה	י ו ר ה ד ע ה
יושר	י ו ש ר
יחזקאל	י ח ז ק א ל
יחזקאל'ן	י ח ז ק א ל נ
יחזקאל'ס	י ח ז ק א ל ס
ייחוס	י י ח ו ס
יייכל	י י י כ ל
ייסגאדאל	י י ס ג א ד א ל
יישוב־הדעת	י י ש ו ב ה ד ע ת
יכולט	י כ ו ל ט
ים	י מ
ים־אויס	י מ א ו י ס
ים־איין	י מ א י י נ
ימח־שמוניג	י מ ח ש מ ו נ י ג
ימים־טובים	י מ י מ ט ו ב י מ
ימים־נוירים	י מ י מ נ ו י ר י מ
ימים־נוירעמדיגער	י מ י מ נ ו י ר ע מ ד י ג ע ר
יסורים	י ס ו ר י מ
יעדויע־וועגילוי	י ע ד ו י ע ו ו ע ג י ל ו י
יעדן	י ע ד נ
יעדנפאלס	י ע ד נ פ א ל ס
יעדע	י ע ד ע
יעדעס	י ע ד ע ס
יעדער	י ע ד ע ר
יעדערן	י ע ד ע ר נ
יעדערער	י ע ד ע ר ע ר
יעכאפויר	י ע כ א פ ו י ר
יעלה	י ע ל ה
יעמיי	י ע מ י י
יענטע	י ע נ ט ע
יענטען	י ע נ ט ע נ
יענע	י ע נ ע
יענעם	י ע נ ע מ
יענעמס	י ע נ ע מ ס
יענער	י ע נ ע ר
יענץ	י ע נ צ
יענקיס	י ע נ ק י ס
יעס	י ע ס
יעצט	י ע צ ט
יצחק	י צ ח ק
יצחק־לייב	י צ ח ק ל י י ב
יצר־הרע	י צ ר ה ר ע
ירא־שמים	י ר א ש מ י מ
ירושה	י ר ו ש ה
יריד	י ר י ד
יריחוס	י ר י ח ו ס
ירשענען	י ר ש ע נ ע נ
יש	י ש
ישיבה	י ש י ב ה
ישיבה־בחורים	י ש י ב ה ב ח ו ר י מ
ישעיהו	י ש ע י ה ו
ישראל	י ש ר א ל
יתום	י ת ו מ
יתומה	י ת ו מ ה
יתומים	י ת ו מ י מ
יתומימדיגע	י ת ו מ י מ ד י ג ע
כ'האב	כ ה א ב
כ'לעבן	כ ל ע ב נ
כא־כא־כא	כ א כ א כ א
כא־כא־כא־כא	כ א כ א כ א כ א
כאטווע	כ א ט ו ו ע
כאטש	כ א ט ש
כאלאט	כ א ל א ט
כאלאטל	כ א ל א ט ל
כאליאסטרע	כ א ל י א ס ט ר ע
כאלערע	כ א ל ע ר ע
כאמולע	כ א מ ו ל ע
כאמעטקעס	כ א מ ע ט ק ע ס
כאסיע	כ א ס י ע
כאסקל	כ א ס ק ל
כאפ	כ א פ
כאפט	כ א פ ט
כאפן	כ א פ נ
כאפנדיג	כ א פ נ ד י ג
כאפעניש	כ א פ ע נ י ש
כאצקל	כ א צ ק ל
כאצקעלע	כ א צ ק ע ל ע
כאראקטער־ראליסט	כ א ר א ק ט ע ר ר א ל י ס ט
כבוד	כ ב ו ד
כדאי	כ ד א י
כדי	כ ד י
כוואליע	כ ו ו א ל י ע
כוואליע־אויס	כ ו ו א ל י ע א ו י ס
כוואליע־איין	כ ו ו א ל י ע א י י נ
כוואליעס	כ ו ו א ל י ע ס
כוונה	כ ו ו נ ה
כוחות	כ ו ח ו ת
כויטווע	כ ו י ט ו ו ע
כוילעסן	כ ו י ל ע ס נ
כוסות	כ ו ס ו ת
כורעים	כ ו ר ע י מ
כח	כ ח
כיד־המלך	כ י ד ה מ ל כ
כיט	כ י ט
כיסא־הכבוד	כ י ס א ה כ ב ו ד
כיעס	כ י ע ס
כיער	כ י ע ר
כישוף	כ י ש ו ף
כיתה	כ י ת ה
כך־הווה	כ כ ה ו ו ה
כל־המינים	כ ל ה מ י נ י מ
כל־השבועות	כ ל ה ש ב ו ע ו ת
כל־השבועות־שבעולם	כ ל ה ש ב ו ע ו ת ש ב ע ו ל מ
כל־זמן	כ ל ז מ נ
כל־טוב	כ ל ט ו ב
כל־ימיו	כ ל י מ י ו
כל־ישראל	כ ל י ש ר א ל
כל־נדרי	כ ל נ ד ר י
כלב	כ ל ב
כלבים	כ ל ב י מ
כלה	כ ל ה
כלה־חן	כ ל ה ח נ
כלה־מיידל	כ ל ה מ י י ד ל
כלהס	כ ל ה ס
כלומרשט	כ ל ו מ ר ש ט
כלי	כ ל י
כלי־בית	כ ל י ב י ת
כלי־זיין	כ ל י ז י י נ
כלי־זמר	כ ל י ז מ ר
כלי־קודש־ווייבער	כ ל י ק ו ד ש ו ו י י ב ע ר
כלים	כ ל י מ
כליפעדיג	כ ל י פ ע ד י ג
כלל	כ ל ל
כמארע	כ מ א ר ע
כמה־וכמה	כ מ ה ו כ מ ה
כמעט	כ מ ע ט
כנופיה	כ נ ו פ י ה
כנסת־ישראל	כ נ ס ת י ש ר א ל
כסדר	כ ס ד ר
כעוורע־קאדיסע	כ ע ו ו ר ע ק א ד י ס ע
כעמער	כ ע מ ע ר
כעס	כ ע ס
כעסבן	כ ע ס ב נ
כעסן	כ ע ס נ
כף־הקלע	כ ף ה ק ל ע
כפרה	כ פ ר ה
כפרות	כ פ ר ו ת
כריין	כ ר י י נ
כרע'מזל'עך	כ ר ע מ ז ל ע כ
כשרע	כ ש ר ע
כשרער	כ ש ר ע ר
כתב	כ ת ב
כתבא־רבא	כ ת ב א ר ב א
כתריאלעווקע	כ ת ר י א ל ע ו ו ק ע
כתריאלעווקער	כ ת ר י א ל ע ו ו ק ע ר
כתרילעווקע	כ ת ר י ל ע ו ו ק ע
לא	ל א
לאבוסדיגע	ל א ב ו ס ד י ג ע
לאדן	ל א ד נ
לאה'לע	ל א ה ל ע
לאז	ל א ז
לאזט	ל א ז ט
לאזן	ל א ז נ
לאזסטו	ל א ז ס ט ו
לאחדים	ל א ח ד י מ
לאחדימניצעס	ל א ח ד י מ נ י צ ע ס
לאטעס	ל א ט ע ס
לאטקע	ל א ט ק ע
לאכט	ל א כ ט
לאכן	ל א כ נ
לאכסט	ל א כ ס ט
לאכעדיגס	ל א כ ע ד י ג ס
לאכעדיגע	ל א כ ע ד י ג ע
לאמטערנדליך	ל א מ ט ע ר נ ד ל י כ
לאמטערנעס	ל א מ ט ע ר נ ע ס
לאמיך	ל א מ י כ
לאמיר	ל א מ י ר
לאמען	ל א מ ע נ
לאמפ	ל א מ פ
לאמפן	ל א מ פ נ
לאנג	ל א נ ג
לאנג־געפרוירענער	ל א נ ג ג ע פ ר ו י ר ע נ ע ר
לאנג־שנייע־שנירלעך	ל א נ ג ש נ י י ע ש נ י ר ל ע כ
לאנגן	ל א נ ג נ
לאנגע	ל א נ ג ע
לאנגער	ל א נ ג ע ר
לאנגערע	ל א נ ג ע ר ע
לאנד	ל א נ ד
לאנקעס	ל א נ ק ע ס
לאסט	ל א ס ט
לאפן	ל א פ נ
לאפעטע	ל א פ ע ט ע
לאפעס	ל א פ ע ס
לאק	ל א ק
לאקן	ל א ק נ
לאקשן	ל א ק ש נ
לארד	ל א ר ד
לאשטשעט	ל א ש ט ש ע ט
לאשעקל	ל א ש ע ק ל
לאשעקלעך	ל א ש ע ק ל ע כ
לבנה	ל ב נ ה
לברכה	ל ב ר כ ה
לג־בעומר	ל ג ב ע ו מ ר
לדוגמא	ל ד ו ג מ א
לדור	ל ד ו ר
להבדיל	ל ה ב ד י ל
להוט	ל ה ו ט
להכעיס	ל ה כ ע י ס
לוויה	ל ו ו י ה
לויב	ל ו י ב
לויבט	ל ו י ב ט
לויט	ל ו י ט
לוימעך	ל ו י מ ע כ
לוין	ל ו י נ
לויף	ל ו י ף
לויפט	ל ו י פ ט
לויפן	ל ו י פ נ
לויפסט	ל ו י פ ס ט
לויפעניש	ל ו י פ ע נ י ש
לויפערס	ל ו י פ ע ר ס
לולקעס	ל ו ל ק ע ס
לונג	ל ו נ ג
לונג־און־לעבערס	ל ו נ ג א ו נ ל ע ב ע ר ס
לוסטיגער	ל ו ס ט י ג ע ר
לופט	ל ו פ ט
לוריא	ל ו ר י א
לחלוטין	ל ח ל ו ט י נ
לחם	ל ח מ
ליאדע	ל י א ד ע
ליאפעס	ל י א פ ע ס
ליארעם	ל י א ר ע מ
ליב	ל י ב
ליבליך	ל י ב ל י כ
ליבלינגען	ל י ב ל י נ ג ע נ
ליבן	ל י ב נ
ליבסטע	ל י ב ס ט ע
ליבע	ל י ב ע
ליבעס	ל י ב ע ס
ליבעסלידער	ל י ב ע ס ל י ד ע ר
ליבער	ל י ב ע ר
ליבשאפט	ל י ב ש א פ ט
ליג	ל י ג
ליגט	ל י ג ט
ליגן	ל י ג נ
ליגנדיג	ל י ג נ ד י ג
ליגנער	ל י ג נ ע ר
ליגערן	ל י ג ע ר נ
לידל	ל י ד ל
ליהודים	ל י ה ו ד י מ
ליוביסטיק	ל י ו ב י ס ט י ק
ליוסטרינענע	ל י ו ס ט ר י נ ע נ ע
ליטוואק	ל י ט ו ו א ק
ליטוואקעס	ל י ט ו ו א ק ע ס
ליטע	ל י ט ע
ליי	ל י י
לייב	ל י י ב
לייבל	ל י י ב ל
לייבן	ל י י ב נ
לייבקע	ל י י ב ק ע
לייג	ל י י ג
לייגט	ל י י ג ט
לייגן	ל י י ג נ
ליידיג	ל י י ד י ג
ליידיגן	ל י י ד י ג נ
ליידיגע	ל י י ד י ג ע
ליידיגער	ל י י ד י ג ע ר
ליידן	ל י י ד נ
לייוונט	ל י י ו ו נ ט
לייוונטענע	ל י י ו ו נ ט ע נ ע
לייזט	ל י י ז ט
לייזן	ל י י ז נ
לייזער	ל י י ז ע ר
לייזער־יאסל	ל י י ז ע ר י א ס ל
לייזער־יאסלען	ל י י ז ע ר י א ס ל ע נ
לייט	ל י י ט
לייטזעליגקייט	ל י י ט ז ע ל י ג ק י י ט
לייטישן	ל י י ט י ש נ
לייטליך	ל י י ט ל י כ
לייטער	ל י י ט ע ר
לייכט	ל י י כ ט
לייכטן	ל י י כ ט נ
לייכטע	ל י י כ ט ע
לייכטער	ל י י כ ט ע ר
ליים	ל י י מ
ליינט	ל י י נ ט
ליינען	ל י י נ ע נ
לייענדיג	ל י י ע נ ד י ג
לייצעס	ל י י צ ע ס
לייקע	ל י י ק ע
ליכט	ל י כ ט
ליכטיג	ל י כ ט י ג
ליכטיגן	ל י כ ט י ג נ
ליכטיגע	ל י כ ט י ג ע
ליכטיגער	ל י כ ט י ג ע ר
ליכטיגקייט	ל י כ ט י ג ק י י ט
ליכטיגקייטן	ל י כ ט י ג ק י י ט נ
ליכטל	ל י כ ט ל
ליכטליך	ל י כ ט ל י כ
ליכטעפעקטן	ל י כ ט ע פ ע ק ט נ
ליכטפלאמען	ל י כ ט פ ל א מ ע נ
לימאנאד	ל י מ א נ א ד
לימענע	ל י מ ע נ ע
לינקס	ל י נ ק ס
לינקער	ל י נ ק ע ר
ליסט	ל י ס ט
ליפ	ל י פ
ליפן	ל י פ נ
ליפנביימער	ל י פ נ ב י י מ ע ר
ליפעס	ל י פ ע ס
ליציטירט	ל י צ י ט י ר ט
ליקדושעס	ל י ק ד ו ש ע ס
לכבוד	ל כ ב ו ד
לכל־הדעות	ל כ ל ה ד ע ו ת
לכתחילה	ל כ ת ח י ל ה
למאי	ל מ א י
למד־וואוו	ל מ ד ו ו א ו ו
למדן	ל מ ד נ
למען־השם	ל מ ע נ ה ש מ
למשל	ל מ ש ל
לן	ל נ
לסוף	ל ס ו ף
לעב	ל ע ב
לעבט	ל ע ב ט
לעבן	ל ע ב נ
לעבסט	ל ע ב ס ט
לעבעדיג	ל ע ב ע ד י ג
לעבעדיגע	ל ע ב ע ד י ג ע
לעבעדיגער	ל ע ב ע ד י ג ע ר
לעבעדיגערהייט	ל ע ב ע ד י ג ע ר ה י י ט
לעדער	ל ע ד ע ר
לעדערנע	ל ע ד ע ר נ ע
לעדערנעם	ל ע ד ע ר נ ע מ
לעהאכאסן	ל ע ה א כ א ס נ
לעז	ל ע ז
לעיטער	ל ע י ט ע ר
לעיילא	ל ע י י ל א
לעכאכאמים	ל ע כ א כ א מ י מ
לעכער	ל ע כ ע ר
לעכעראסיינו	ל ע כ ע ר א ס י י נ ו
לעכערדיגן	ל ע כ ע ר ד י ג נ
לעכערט	ל ע כ ע ר ט
לעכערן	ל ע כ ע ר נ
לעמא	ל ע מ א
לעמאן־האסעם	ל ע מ א נ ה א ס ע מ
לעמבערג	ל ע מ ב ע ר ג
לענג	ל ע נ ג
לענגליכע	ל ע נ ג ל י כ ע
לענגערע	ל ע נ ג ע ר ע
לענדער	ל ע נ ד ע ר
לעפל	ל ע פ ל
לעפצן	ל ע פ צ נ
לעצטגעלט	ל ע צ ט ג ע ל ט
לעצטן	ל ע צ ט נ
לעצטע	ל ע צ ט ע
לעצטער	ל ע צ ט ע ר
לעק	ל ע ק
לעקאבעץ	ל ע ק א ב ע צ
לעקט	ל ע ק ט
לעקיש	ל ע ק י ש
לעקן	ל ע ק נ
לעקעך	ל ע ק ע כ
לעקעכער	ל ע ק ע כ ע ר
לערן	ל ע ר נ
לערנט	ל ע ר נ ט
לערנסטו	ל ע ר נ ס ט ו
לערנען	ל ע ר נ ע נ
לערער	ל ע ר ע ר
לצים	ל צ י מ
לצעווען	ל צ ע ו ו ע נ
לשון	ל ש ו נ
לשון־קודש	ל ש ו נ ק ו ד ש
לשם	ל ש מ
מ'	מ
מ'באדארף	מ ב א ד א ר ף
מ'גיט	מ ג י ט
מ'גייט	מ ג י י ט
מ'גיסט	מ ג י ס ט
מ'גנב'עט	מ ג נ ב ע ט
מ'געוויינט	מ ג ע ו ו י י נ ט
מ'געפינט	מ ג ע פ י נ ט
מ'דארף	מ ד א ר ף
מ'דערזעהט	מ ד ע ר ז ע ה ט
מ'דערלאנגט	מ ד ע ר ל א נ ג ט
מ'דרייט	מ ד ר י י ט
מ'האט	מ ה א ט
מ'האלט	מ ה א ל ט
מ'הייבט	מ ה י י ב ט
מ'היילט	מ ה י י ל ט
מ'וואלט	מ ו ו א ל ט
מ'ווארפט	מ ו ו א ר פ ט
מ'וואשט	מ ו ו א ש ט
מ'וויל	מ ו ו י ל
מ'וועט	מ ו ו ע ט
מ'זאגט	מ ז א ג ט
מ'זאל	מ ז א ל
מ'זיצט	מ ז י צ ט
מ'זעהט	מ ז ע ה ט
מ'זעט	מ ז ע ט
מ'זעצט	מ ז ע צ ט
מ'טאר	מ ט א ר
מ'טוט	מ ט ו ט
מ'לאכט	מ ל א כ ט
מ'לייגט	מ ל י י ג ט
מ'מאכט	מ מ א כ ט
מ'מוז	מ מ ו ז
מ'מוטשעט	מ מ ו ט ש ע ט
מ'מינטערט	מ מ י נ ט ע ר ט
מ'מעג	מ מ ע ג
מ'נעמט	מ נ ע מ ט
מ'סודעט	מ ס ו ד ע ט
מ'עסט	מ ע ס ט
מ'פאלט	מ פ א ל ט
מ'פארגינט	מ פ א ר ג י נ ט
מ'פארפעסטיגט	מ פ א ר פ ע ס ט י ג ט
מ'פארקויפט	מ פ א ר ק ו י פ ט
מ'פארקניפט	מ פ א ר ק נ י פ ט
מ'פירט	מ פ י ר ט
מ'פליט	מ פ ל י ט
מ'פלעגט	מ פ ל ע ג ט
מ'פרעגט	מ פ ר ע ג ט
מ'פרעגלט	מ פ ר ע ג ל ט
מ'צעטיילט	מ צ ע ט י י ל ט
מ'קאכט	מ ק א כ ט
מ'קאן	מ ק א נ
מ'קומט	מ ק ו מ ט
מ'קוקט	מ ק ו ק ט
מ'קלאפט	מ ק ל א פ ט
מ'קען	מ ק ע נ
מ'קראצט	מ ק ר א צ ט
מ'קריכט	מ ק ר י כ ט
מ'קרענקט	מ ק ר ע נ ק ט
מ'רופט	מ ר ו פ ט
מ'רייסט	מ ר י י ס ט
מ'רירט	מ ר י ר ט
מ'רעדט	מ ר ע ד ט
מ'שאקלט	מ ש א ק ל ט
מ'שווייגט	מ ש ו ו י י ג ט
מ'שטייט	מ ש ט י י ט
מ'שטעלט	מ ש ט ע ל ט
מ'שיט	מ ש י ט
מ'שלאגט	מ ש ל א ג ט
מ'שמועסט	מ ש מ ו ע ס ט
מ'שמעקט	מ ש מ ע ק ט
מ'שרייבט	מ ש ר י י ב ט
מ'שרייט	מ ש ר י י ט
מאגן	מ א ג נ
מאגערס	מ א ג ע ר ס
מאדנע	מ א ד נ ע
מאדנעם	מ א ד נ ע מ
מאדנער	מ א ד נ ע ר
מאדע	מ א ד ע
מאדעס	מ א ד ע ס
מאטיוו	מ א ט י ו ו
מאטיוון	מ א ט י ו ו נ
מאטל	מ א ט ל
מאטלען	מ א ט ל ע נ
מאטע	מ א ט ע
מאטעלע	מ א ט ע ל ע
מאטעלעס	מ א ט ע ל ע ס
מאטעריע	מ א ט ע ר י ע
מאטערניש	מ א ט ע ר נ י ש
מאים	מ א י מ
מאיר	מ א י ר
מאך	מ א כ
מאכט	מ א כ ט
מאכל	מ א כ ל
מאכן	מ א כ נ
מאכנדיג	מ א כ נ ד י ג
מאכער	מ א כ ע ר
מאל	מ א ל
מאלט	מ א ל ט
מאלינעס	מ א ל י נ ע ס
מאלן	מ א ל נ
מאלערוסיש	מ א ל ע ר ו ס י ש
מאמע	מ א מ ע
מאמע־לשון	מ א מ ע ל ש ו נ
מאמען	מ א מ ע נ
מאמעס	מ א מ ע ס
מאמרים	מ א מ ר י מ
מאן	מ א נ
מאנאט	מ א נ א ט
מאנאלאג	מ א נ א ל א ג
מאנארכס	מ א נ א ר כ ס
מאנטל	מ א נ ט ל
מאנטלען	מ א נ ט ל ע נ
מאניפארגע	מ א נ י פ א ר ג ע
מאנישקע	מ א נ י ש ק ע
מאנס	מ א נ ס
מאנספארשוינען	מ א נ ס פ א ר ש ו י נ ע נ
מאנספערזאנען	מ א נ ס פ ע ר ז א נ ע נ
מאנען	מ א נ ע נ
מאנענדיג	מ א נ ע נ ד י ג
מאנצביל	מ א נ צ ב י ל
מאנצבילדיג	מ א נ צ ב י ל ד י ג
מאנצבילן	מ א נ צ ב י ל נ
מאנצבילש	מ א נ צ ב י ל ש
מאנצבילשן	מ א נ צ ב י ל ש נ
מאנצבילשע	מ א נ צ ב י ל ש ע
מאנצבילשער	מ א נ צ ב י ל ש ע ר
מאס	מ א ס
מאסאזש	מ א ס א ז ש
מאסן	מ א ס נ
מאסע	מ א ס ע
מארבין	מ א ר ב י נ
מארגן	מ א ר ג נ
מארדע	מ א ר ד ע
מארדעלע	מ א ר ד ע ל ע
מארכביין	מ א ר כ ב י י נ
מארעלן	מ א ר ע ל נ
מארק	מ א ר ק
מארקעס	מ א ר ק ע ס
מארש	מ א ר ש
מאשין	מ א ש י נ
מאשינע	מ א ש י נ ע
מאשינעס	מ א ש י נ ע ס
מבטיח	מ ב ט י ח
מבין	מ ב י נ
מבינים	מ ב י נ י מ
מגושם	מ ג ו ש מ
מגייר	מ ג י י ר
מגן־אבות	מ ג נ א ב ו ת
מגן־דוד	מ ג נ ד ו ד
מדבריות	מ ד ב ר י ו ת
מדור	מ ד ו ר
מדרש	מ ד ר ש
מה	מ ה
מהומה	מ ה ו מ ה
מהיכא־תיתי	מ ה י כ א ת י ת י
מודה	מ ו ד ה
מוהל	מ ו ה ל
מוהלשאפט	מ ו ה ל ש א פ ט
מוז	מ ו ז
מוזט	מ ו ז ט
מוזן	מ ו ז נ
מוזסט	מ ו ז ס ט
מוח	מ ו ח
מוחל	מ ו ח ל
מוט	מ ו ט
מוטער	מ ו ט ע ר
מוטערליכער	מ ו ט ע ר ל י כ ע ר
מוטערס	מ ו ט ע ר ס
מוטשע	מ ו ט ש ע
מוטשעט	מ ו ט ש ע ט
מויל	מ ו י ל
מויערל	מ ו י ע ר ל
מויערן	מ ו י ע ר נ
מוכר־ספרים	מ ו כ ר ס פ ר י מ
מוכר־ספרימניג	מ ו כ ר ס פ ר י מ נ י ג
מומע	מ ו מ ע
מוסף	מ ו ס ף
מוספים	מ ו ס פ י מ
מוסר	מ ו ס ר
מוסר־ספרים	מ ו ס ר ס פ ר י מ
מוסרט	מ ו ס ר ט
מופט	מ ו פ ט
מורא	מ ו ר א
מורא'דיג	מ ו ר א ד י ג
מורא'דיגע	מ ו ר א ד י ג ע
מורא'דיגער	מ ו ר א ד י ג ע ר
מורמלט	מ ו ר מ ל ט
מורקען	מ ו ר ק ע נ
מושטשינע	מ ו ש ט ש י נ ע
מזג־טוב	מ ז ג ט ו ב
מזומן	מ ז ו מ נ
מזומנים	מ ז ו מ נ י מ
מזיק	מ ז י ק
מזכה	מ ז כ ה
מזל	מ ז ל
מזל־טוב	מ ז ל ט ו ב
מזרח	מ ז ר ח
מזרח־וואנט	מ ז ר ח ו ו א נ ט
מחבר	מ ח ב ר
מחויב	מ ח ו י ב
מחותן	מ ח ו ת נ
מחותנים	מ ח ו ת נ י מ
מחותנתטע	מ ח ו ת נ ת ט ע
מחיה	מ ח י ה
מחיה־מתים	מ ח י ה מ ת י מ
מחיה־נפשות	מ ח י ה נ פ ש ו ת
מחילה	מ ח י ל ה
מחלוקה	מ ח ל ו ק ה
מחלוקות	מ ח ל ו ק ו ת
מחלוקת	מ ח ל ו ק ת
מחמת	מ ח מ ת
מחנה	מ ח נ ה
מחנות	מ ח נ ו ת
מחשבה	מ ח ש ב ה
מטבע	מ ט ב ע
מטופל	מ ט ו פ ל
מטמון	מ ט מ ו נ
מטריח	מ ט ר י ח
מי	מ י
מי־יודע	מ י י ו ד ע
מי־שעאמער	מ י ש ע א מ ע ר
מיאוס	מ י א ו ס
מיאוס'ן	מ י א ו ס נ
מיאוס'ע	מ י א ו ס ע
מיאוס'ער	מ י א ו ס ע ר
מיאוס'קייטן	מ י א ו ס ק י י ט נ
מיאטש	מ י א ט ש
מידע	מ י ד ע
מיוחס	מ י ו ח ס
מיוחסים	מ י ו ח ס י מ
מיזיניג	מ י ז י נ י ג
מיזמור	מ י ז מ ו ר
מיט	מ י ט
מיטאג	מ י ט א ג
מיטאמאל	מ י ט א מ א ל
מיטברענגען	מ י ט ב ר ע נ ג ע נ
מיטגעבראכט	מ י ט ג ע ב ר א כ ט
מיטגעהאלטן	מ י ט ג ע ה א ל ט נ
מיטגענומען	מ י ט ג ע נ ו מ ע נ
מיטגעשאקלט	מ י ט ג ע ש א ק ל ט
מיטגעשלעפט	מ י ט ג ע ש ל ע פ ט
מיטלסטן	מ י ט ל ס ט נ
מיטן	מ י ט נ
מיטנעמען	מ י ט נ ע מ ע נ
מיטפירן	מ י ט פ י ר נ
מיטקאווסקין	מ י ט ק א ו ו ס ק י נ
מיטשלעפנדיג	מ י ט ש ל ע פ נ ד י ג
מיי	מ י י
מיי־	מ י י
מיידט	מ י י ד ט
מיידל	מ י י ד ל
מיידל־ציטערנדיג	מ י י ד ל צ י ט ע ר נ ד י ג
מיידלס	מ י י ד ל ס
מיידלעך	מ י י ד ל ע כ
מיידלשי	מ י י ד ל ש י
מייז	מ י י ז
מייל	מ י י ל
מיילכל	מ י י ל כ ל
מיילעכל	מ י י ל ע כ ל
מיילעכליך	מ י י ל ע כ ל י כ
מיילער	מ י י ל ע ר
מיין	מ י י נ
מיינט	מ י י נ ט
מיינס	מ י י נ ס
מיינסטו	מ י י נ ס ט ו
מיינסטנס	מ י י נ ס ט נ ס
מיינע	מ י י נ ע
מיינעם	מ י י נ ע מ
מיינען	מ י י נ ע נ
מיינער	מ י י נ ע ר
מיישב	מ י י ש ב
מיך	מ י כ
מיכל	מ י כ ל
מיכלען	מ י כ ל ע נ
מיל	מ י ל
מילא	מ י ל א
מיליאן	מ י ל י א נ
מיליאנען	מ י ל י א נ ע נ
מילך	מ י ל כ
מילכיגס	מ י ל כ י ג ס
מילכיגע	מ י ל כ י ג ע
מילנער	מ י ל נ ע ר
מים־אחרונים־וואסער	מ י מ א ח ר ו נ י מ ו ו א ס ע ר
מין	מ י נ
מינדל	מ י נ ד ל
מינוט	מ י נ ו ט
מיני	מ י נ י
מינים	מ י נ י מ
מיניסטער	מ י נ י ס ט ע ר
מינע	מ י נ ע
מיסחר	מ י ס ח ר
מיסט	מ י ס ט
מיסטער	מ י ס ט ע ר
מיר	מ י ר
מיש	מ י ש
מישב	מ י ש ב
מישט	מ י ש ט
מישטיינס	מ י ש ט י י נ ס
מישיישעס	מ י ש י י ש ע ס
מישן	מ י ש נ
מיתה־משונה	מ י ת ה מ ש ו נ ה
מכבד	מ כ ב ד
מכה	מ כ ה
מכו'חן	מ כ ו ח נ
מכוח	מ כ ו ח
מכות	מ כ ו ת
מכשפה	מ כ ש פ ה
מכשפהטע	מ כ ש פ ה ט ע
מל	מ ל
מלא־גזלן	מ ל א ג ז ל נ
מלא־רציחה	מ ל א ר צ י ח ה
מלאך־המוות	מ ל א כ ה מ ו ו ת
מלאך־מליץ	מ ל א כ מ ל י צ
מלאכה	מ ל א כ ה
מלאכים	מ ל א כ י מ
מלאכימדיג	מ ל א כ י מ ד י ג
מלאכימליך	מ ל א כ י מ ל י כ
מלאכימס	מ ל א כ י מ ס
מלאכס	מ ל א כ ס
מלבוש	מ ל ב ו ש
מלבושים	מ ל ב ו ש י מ
מלבושימ'ליך	מ ל ב ו ש י מ ל י כ
מלווה־מלכה	מ ל ו ו ה מ ל כ ה
מלחמה	מ ל ח מ ה
מליץ־יושר	מ ל י צ י ו ש ר
מלך	מ ל כ
מלכה	מ ל כ ה
מלכה'לע	מ ל כ ה ל ע
מלכה'לען	מ ל כ ה ל ע נ
מלכה'לעס	מ ל כ ה ל ע ס
מלכות־ברויטלעך	מ ל כ ו ת ב ר ו י ט ל ע כ
מלמד	מ ל מ ד
מלמדים	מ ל מ ד י מ
ממה־נפשך	מ מ ה נ פ ש כ
ממזרים	מ מ ז ר י מ
ממזרישע	מ מ ז ר י ש ע
ממלא־מקום	מ מ ל א מ ק ו מ
ממלא־מקומו	מ מ ל א מ ק ו מ ו
ממש	מ מ ש
ממשות	מ מ ש ו ת
מן־הסתם	מ נ ה ס ת מ
מן־השמים	מ נ ה ש מ י מ
מנגן	מ נ ג נ
מנהג	מ נ ה ג
מנחה	מ נ ח ה
מנחה־צייט	מ נ ח ה צ י י ט
מנין	מ נ י נ
מניעה	מ נ י ע ה
מנשה	מ נ ש ה
מנשה'כע	מ נ ש ה כ ע
מנשה'כען	מ נ ש ה כ ע נ
מנשה'ן	מ נ ש ה נ
מסבב	מ ס ב ב
מסוגל	מ ס ו ג ל
מסופק	מ ס ו פ ק
מסירהלע	מ ס י ר ה ל ע
מסירות־נפש	מ ס י ר ו ת נ פ ש
מסירת־הנפש	מ ס י ר ת ה נ פ ש
מסירת־נפש	מ ס י ר ת נ פ ש
מסכים	מ ס כ י מ
מסכתא	מ ס כ ת א
מסרט	מ ס ר ט
מסתמא	מ ס ת מ א
מעבל	מ ע ב ל
מעג	מ ע ג
מעגט	מ ע ג ט
מעגליך	מ ע ג ל י כ
מעגן	מ ע ג נ
מעגסט	מ ע ג ס ט
מעטאדעס	מ ע ט א ד ע ס
מעיבי	מ ע י ב י
מעכוטאנעסטע	מ ע כ ו ט א נ ע ס ט ע
מעכטיגע	מ ע כ ט י ג ע
מעל	מ ע ל
מעלגעשעפט	מ ע ל ג ע ש ע פ ט
מעלה	מ ע ל ה
מעלה־גירהן	מ ע ל ה ג י ר ה נ
מעלות	מ ע ל ו ת
מעליך	מ ע ל י כ
מעליס	מ ע ל י ס
מעליצעס	מ ע ל י צ ע ס
מעמיילע־מעקוימוי	מ ע מ י י ל ע מ ע ק ו י מ ו י
מען	מ ע נ
מענדל	מ ע נ ד ל
מענדל־ליב	מ ע נ ד ל ל י ב
מענדלען	מ ע נ ד ל ע נ
מענדעלע	מ ע נ ד ע ל ע
מענות	מ ע נ ו ת
מענטש	מ ע נ ט ש
מענטשל	מ ע נ ט ש ל
מענטשליך	מ ע נ ט ש ל י כ
מענטשליכן	מ ע נ ט ש ל י כ נ
מענטשליכער	מ ע נ ט ש ל י כ ע ר
מענטשן	מ ע נ ט ש נ
מענטשן־קרוין	מ ע נ ט ש נ ק ר ו י נ
מענטשנס	מ ע נ ט ש נ ס
מענטשעלעך	מ ע נ ט ש ע ל ע כ
מעני	מ ע נ י
מענין	מ ע נ י נ
מענער	מ ע נ ע ר
מעסט	מ ע ס ט
מעסער	מ ע ס ע ר
מעסערל	מ ע ס ע ר ל
מעקט	מ ע ק ט
מעקלער	מ ע ק ל ע ר
מעקלערס	מ ע ק ל ע ר ס
מעקן	מ ע ק נ
מעקסיגע	מ ע ק ס י ג ע
מער	מ ע ר
מערב	מ ע ר ב
מעריב	מ ע ר י ב
מערסטנטייל	מ ע ר ס ט נ ט י י ל
מערסטנטיילס	מ ע ר ס ט נ ט י י ל ס
מערסטנס	מ ע ר ס ט נ ס
מערסטע	מ ע ר ס ט ע
מערער	מ ע ר ע ר
מערקט	מ ע ר ק ט
מעשה	מ ע ש ה
מעשיות	מ ע ש י ו ת
מעשענע	מ ע ש ע נ ע
מעשענעם	מ ע ש ע נ ע מ
מפלה	מ פ ל ה
מפני־דרכי־שלום	מ פ נ י ד ר כ י ש ל ו מ
מפפו	מ פ פ ו
מפרשים	מ פ ר ש י מ
מצד	מ צ ד
מצה	מ צ ה
מצה־שמורה	מ צ ה ש מ ו ר ה
מצוה	מ צ ו ה
מצוות	מ צ ו ו ת
מצות	מ צ ו ת
מציאה	מ צ י א ה
מציאות	מ צ י א ו ת
מציבה	מ צ י ב ה
מציבות	מ צ י ב ו ת
מצליח	מ צ ל י ח
מקבל	מ ק ב ל
מקבל־פנים	מ ק ב ל פ נ י מ
מקום	מ ק ו מ
מקום־מנוחה	מ ק ו מ מ נ ו ח ה
מקיים	מ ק י י מ
מקנא	מ ק נ א
מרדכי	מ ר ד כ י
מרדכין	מ ר ד כ י נ
מרור	מ ר ו ר
מרחץ	מ ר ח צ
מרשעת	מ ר ש ע ת
משא	מ ש א
משה	מ ש ה
משה'לע	מ ש ה ל ע
משוגע	מ ש ו ג ע
משוגענער	מ ש ו ג ע נ ע ר
משוגענערהייט	מ ש ו ג ע נ ע ר ה י י ט
משולח	מ ש ו ל ח
משומד	מ ש ו מ ד
משונה	מ ש ו נ ה
משוררים	מ ש ו ר ר י מ
משי'חן	מ ש י ח נ
משיחס	מ ש י ח ס
משכונות	מ ש כ ו נ ו ת
משלים	מ ש ל י מ
משלנו	מ ש ל נ ו
משניותן	מ ש נ י ו ת נ
משפחה	מ ש פ ח ה
משפחה־גריבעלעך	מ ש פ ח ה ג ר י ב ע ל ע כ
משפחהדיג	מ ש פ ח ה ד י ג
משפטן	מ ש פ ט נ
משקה	מ ש ק ה
משתדל	מ ש ת ד ל
מת	מ ת
מתים	מ ת י מ
מתיקותדיגע	מ ת י ק ו ת ד י ג ע
מתיר	מ ת י ר
מתנגדישער	מ ת נ ג ד י ש ע ר
מתנה	מ ת נ ה
מתנות	מ ת נ ו ת
מתקן	מ ת ק נ
נא	נ א
נאגל	נ א ג ל
נאגן	נ א ג נ
נאדל	נ א ד ל
נאדלען	נ א ד ל ע נ
נאז	נ א ז
נאזפאטשיילע	נ א ז פ א ט ש י י ל ע
נאט	נ א ט
נאטור	נ א ט ו ר
נאטור־געזאנג	נ א ט ו ר ג ע ז א נ ג
נאטירליך	נ א ט י ר ל י כ
נאטן	נ א ט נ
נאטע	נ א ט ע
נאטען	נ א ט ע נ
נאטעס	נ א ט ע ס
נאיס	נ א י ס
נאך	נ א כ
נאך־ניט־באוואקסענע	נ א כ נ י ט ב א ו ו א ק ס ע נ ע
נאך־פסח	נ א כ פ ס ח
נאך־פסח'דיקן	נ א כ פ ס ח ד י ק נ
נאכאלץ	נ א כ א ל צ
נאכאמאל	נ א כ א מ א ל
נאכאנאנד	נ א כ א נ א נ ד
נאכגעבאמבלט	נ א כ ג ע ב א מ ב ל ט
נאכגעבויגט	נ א כ ג ע ב ו י ג ט
נאכגעטון	נ א כ ג ע ט ו נ
נאכגעטראכט	נ א כ ג ע ט ר א כ ט
נאכגעיאגט	נ א כ ג ע י א ג ט
נאכגעלאזט	נ א כ ג ע ל א ז ט
נאכגעמאכט	נ א כ ג ע מ א כ ט
נאכגעפארשט	נ א כ ג ע פ א ר ש ט
נאכגעצויגן	נ א כ ג ע צ ו י ג נ
נאכגעשאלטן	נ א כ ג ע ש א ל ט נ
נאכגעשאקלט	נ א כ ג ע ש א ק ל ט
נאכגעשטופט	נ א כ ג ע ש ט ו פ ט
נאכגעשלעפט	נ א כ ג ע ש ל ע פ ט
נאכדעם	נ א כ ד ע מ
נאכט	נ א כ ט
נאכט־ים	נ א כ ט י מ
נאכט־לאמטערנדליך	נ א כ ט ל א מ ט ע ר נ ד ל י כ
נאכט־שלייער	נ א כ ט ש ל י י ע ר
נאכטאנצן	נ א כ ט א נ צ נ
נאכטטוי	נ א כ ט ט ו י
נאכטכאר	נ א כ ט כ א ר
נאכטנעפל	נ א כ ט נ ע פ ל
נאכמאכן	נ א כ מ א כ נ
נאכן	נ א כ נ
נאכן־אנבייסן	נ א כ נ א נ ב י י ס נ
נאכנישט	נ א כ נ י ש ט
נאכציען	נ א כ צ י ע נ
נאמנות	נ א מ נ ו ת
נאמען	נ א מ ע נ
נאס	נ א ס
נאסליכן	נ א ס ל י כ נ
נאסן	נ א ס נ
נאסע	נ א ס ע
נאסער	נ א ס ע ר
נאענט	נ א ע נ ט
נאענסטע	נ א ע נ ס ט ע
נאציאן	נ א צ י א נ
נאקעט	נ א ק ע ט
נאקעטע	נ א ק ע ט ע
נאר	נ א ר
נאראנים	נ א ר א נ י מ
נאריש	נ א ר י ש
נארישע	נ א ר י ש ע
נארישער	נ א ר י ש ע ר
נארישקייטן	נ א ר י ש ק י י ט נ
נארן	נ א ר נ
נארקענדיג	נ א ר ק ע נ ד י ג
נאשער	נ א ש ע ר
נאשעריי	נ א ש ע ר י י
נביא	נ ב י א
נבלה	נ ב ל ה
נגיד	נ ג י ד
נגידיש־חסיד'ישע	נ ג י ד י ש ח ס י ד י ש ע
נגידישן	נ ג י ד י ש נ
נגידישע	נ ג י ד י ש ע
נגידישער	נ ג י ד י ש ע ר
נגידישקייט	נ ג י ד י ש ק י י ט
נגידס	נ ג י ד ס
נגינה	נ ג י נ ה
נדן	נ ד נ
נדרים	נ ד ר י מ
נו	נ ו
נו־נו	נ ו נ ו
נוגע	נ ו ג ע
נוהג	נ ו ה ג
נויגט	נ ו י ג ט
נויט	נ ו י ט
נויטיג	נ ו י ט י ג
נויטיגע	נ ו י ט י ג ע
נויטן	נ ו י ט נ
נוסח	נ ו ס ח
נוץ	נ ו צ
נוקם־ונוטר	נ ו ק מ ו נ ו ט ר
נושאי־המיטה	נ ו ש א י ה מ י ט ה
נח	נ ח
נחמן	נ ח מ נ
נחת	נ ח ת
ניאוו־	נ י א ו ו
ניאווקעט	נ י א ו ו ק ע ט
ניאווקען	נ י א ו ו ק ע נ
ניבהל־ונשתומם	נ י ב ה ל ו נ ש ת ו מ מ
ניגון	נ י ג ו נ
ניגון'דל	נ י ג ו נ ד ל
ניגונים	נ י ג ו נ י מ
נידריג	נ י ד ר י ג
נידריגס	נ י ד ר י ג ס
נידריגע	נ י ד ר י ג ע
נידריגער	נ י ד ר י ג ע ר
ניונקעלע	נ י ו נ ק ע ל ע
ניחא	נ י ח א
ניט	נ י ט
ניט־פארגינער	נ י ט פ א ר ג י נ ע ר
ניטא	נ י ט א
ניטבאקעש	נ י ט ב א ק ע ש
ניי	נ י י
ניי־געבוירענעם	נ י י ג ע ב ו י ר ע נ ע מ
נייגעריגקייט	נ י י ג ע ר י ג ק י י ט
ניין	נ י י נ
ניינציג	נ י י נ צ י ג
נייס	נ י י ס
נייע	נ י י ע
נייעם	נ י י ע מ
נייעס	נ י י ע ס
נייער	נ י י ע ר
ניכטער	נ י כ ט ע ר
נימאנד	נ י מ א נ ד
נימאס	נ י מ א ס
ניץ	נ י צ
נישט	נ י ש ט
נישטא	נ י ש ט א
נישמער	נ י ש מ ע ר
נישקשה	נ י ש ק ש ה
נישקשהדיג	נ י ש ק ש ה ד י ג
נס	נ ס
נסים	נ ס י מ
נסיעה	נ ס י ע ה
נע־ונד	נ ע ו נ ד
נעבן	נ ע ב נ
נעבעך	נ ע ב ע כ
נעגל	נ ע ג ל
נעגעליך	נ ע ג ע ל י כ
נעדאיעד	נ ע ד א י ע ד
נעז	נ ע ז
נעזל	נ ע ז ל
נעילה	נ ע י ל ה
נעכט	נ ע כ ט
נעכטיגע	נ ע כ ט י ג ע
נעכטיגער	נ ע כ ט י ג ע ר
נעכטן	נ ע כ ט נ
נעכיי	נ ע כ י י
נעלם	נ ע ל מ
נעלסאן	נ ע ל ס א נ
נעם	נ ע מ
נעמט	נ ע מ ט
נעמיראווער	נ ע מ י ר א ו ו ע ר
נעמסט	נ ע מ ס ט
נעמען	נ ע מ ע נ
נעס	נ ע ס
נעסט	נ ע ס ט
נעענטער	נ ע ע נ ט ע ר
נעפל	נ ע פ ל
נעפלען	נ ע פ ל ע נ
נעפרעמענע	נ ע פ ר ע מ ע נ ע
נערוון	נ ע ר ו ו נ
נפטר	נ פ ט ר
נפש	נ פ ש
נפשות	נ פ ש ו ת
נצחון	נ צ ח ו נ
נקמה	נ ק מ ה
נשמה	נ ש מ ה
נשמה־ליכטליך	נ ש מ ה ל י כ ט ל י כ
נשמות	נ ש מ ו ת
ס'א	ס א
ס'איז	ס א י ז
ס'ארט	ס א ר ט
ס'געהער	ס ג ע ה ע ר
ס'געשעט	ס ג ע ש ע ט
ס'דאך	ס ד א כ
ס'דרייט	ס ד ר י י ט
ס'האבן	ס ה א ב נ
ס'האט	ס ה א ט
ס'וואלט	ס ו ו א ל ט
ס'ווייזט	ס ו ו י י ז ט
ס'וועט	ס ו ו ע ט
ס'ווערט	ס ו ו ע ר ט
ס'זאל	ס ז א ל
ס'טוט	ס ט ו ט
ס'טייטש	ס ט י י ט ש
ס'מאכט	ס מ א כ ט
ס'ניי	ס נ י י
ס'קאן	ס ק א נ
ס'קול	ס ק ו ל
ס'קומט	ס ק ו מ ט
ס'קען	ס ק ע נ
ס'שיילט	ס ש י י ל ט
ס'שמעקט	ס ש מ ע ק ט
ס'שרייבט	ס ש ר י י ב ט
סאדע־וואסער	ס א ד ע ו ו א ס ע ר
סאך	ס א כ
סאלאווייטשיק	ס א ל א ו ו י י ט ש י ק
סאלאן	ס א ל א נ
סאמאסים	ס א מ א ס י מ
סאמע	ס א מ ע
סאמעט	ס א מ ע ט
סאמעט־בלעטל	ס א מ ע ט ב ל ע ט ל
סאמעטן	ס א מ ע ט נ
סאמעטענע	ס א מ ע ט ע נ ע
סאמעטענער	ס א מ ע ט ע נ ע ר
סאנישניג	ס א נ י ש נ י ג
סאנישניקעס	ס א נ י ש נ י ק ע ס
סאפנדיגע	ס א פ נ ד י ג ע
סאפע	ס א פ ע
סאפראנא	ס א פ ר א נ א
סאפראנא־שטימע	ס א פ ר א נ א ש ט י מ ע
סאקאלסקין	ס א ק א ל ס ק י נ
סארטן	ס א ר ט נ
סביבה	ס ב י ב ה
סביבות	ס ב י ב ו ת
סברה	ס ב ר ה
סגולה	ס ג ו ל ה
סגולות	ס ג ו ל ו ת
סדר	ס ד ר
סדרה	ס ד ר ה
סוד	ס ו ד
סודות	ס ו ד ו ת
סודותדיגע	ס ו ד ו ת ד י ג ע
סודען	ס ו ד ע נ
סוחר	ס ו ח ר
סוחרים	ס ו ח ר י מ
סוחרימלעך	ס ו ח ר י מ ל ע כ
סוטערינע	ס ו ט ע ר י נ ע
סוף	ס ו ף
סוף־כל־סוף	ס ו ף כ ל ס ו ף
סופליאר	ס ו פ ל י א ר
סוקע	ס ו ק ע
סחורה	ס ח ו ר ה
סחורות	ס ח ו ר ו ת
סטאט	ס ט א ט
סטאליארעס	ס ט א ל י א ר ע ס
סטאליער	ס ט א ל י ע ר
סטאנציע	ס ט א נ צ י ע
סטאפט	ס ט א פ ט
סטאר	ס ט א ר
סטודענטל	ס ט ו ד ע נ ט ל
סטוסאקעס	ס ט ו ס א ק ע ס
סטייטץ	ס ט י י ט צ
סטייטש	ס ט י י ט ש
סטעישאנערי	ס ט ע י ש א נ ע ר י
סטעליע	ס ט ע ל י ע
סטענגעלע	ס ט ע נ ג ע ל ע
סטעפאן	ס ט ע פ א נ
סטראנקעס	ס ט ר א נ ק ע ס
סטראשען	ס ט ר א ש ע נ
סטרונעס	ס ט ר ו נ ע ס
סטשערבעס	ס ט ש ע ר ב ע ס
סיבה	ס י ב ה
סידור	ס י ד ו ר
סידורל	ס י ד ו ר ל
סיי	ס י י
סיידן	ס י י ד נ
סילוק	ס י ל ו ק
סימן	ס י מ נ
סינאגאגע	ס י נ א ג א ג ע
סיצן	ס י צ נ
סך־הכל	ס כ ה כ ל
סכנה	ס כ נ ה
סכנות	ס כ נ ו ת
סכנות־נפשות	ס כ נ ו ת נ פ ש ו ת
סלאף	ס ל א ף
סליחות	ס ל י ח ו ת
סליחות־צייט	ס ל י ח ו ת צ י י ט
סליעדאוואטל	ס ל י ע ד א ו ו א ט ל
סם־המוות	ס מ ה מ ו ו ת
סמאלינע	ס מ א ל י נ ע
סמאלע	ס מ א ל ע
סמיכות־הפרשה	ס מ י כ ו ת ה פ ר ש ה
סמעטענע	ס מ ע ט ע נ ע
סנאסט	ס נ א ס ט
סנדקאות	ס נ ד ק א ו ת
סעדער	ס ע ד ע ר
סעודה	ס ע ו ד ה
סעמען	ס ע מ ע נ
סענאט	ס ע נ א ט
סענאטארן	ס ע נ א ט א ר נ
סערמיענגע	ס ע ר מ י ע נ ג ע
סערמענגע	ס ע ר מ ע נ ג ע
ספאדיק	ס פ א ד י ק
ספאזמע	ס פ א ז מ ע
ספעציאליסט	ס פ ע צ י א ל י ס ט
ספעציאליסטן	ס פ ע צ י א ל י ס ט נ
ספעציאלנאסט	ס פ ע צ י א ל נ א ס ט
ספר	ס פ ר
ספרים	ס פ ר י מ
סצענע	ס צ ע נ ע
סקאטינא	ס ק א ט י נ א
סקאטינע	ס ק א ט י נ ע
סקאטינעס	ס ק א ט י נ ע ס
סקאנדאל	ס ק א נ ד א ל
סקיצן	ס ק י צ נ
סקריפ	ס ק ר י פ
סקריפען	ס ק ר י פ ע נ
סתם	ס ת מ
עבירה	ע ב י ר ה
עברי	ע ב ר י
עגמת־נפש	ע ג מ ת נ פ ש
עד־היום	ע ד ה י ו מ
עדה	ע ד ה
עדות	ע ד ו ת
עוויגעס	ע ו ו י ג ע ס
עוולה	ע ו ו ל ה
עוזר	ע ו ז ר
עוזר'ל	ע ו ז ר ל
עוזר'ן	ע ו ז ר נ
עוזר'ס	ע ו ז ר ס
עול	ע ו ל
עולה־לגדולה	ע ו ל ה ל ג ד ו ל ה
עולם	ע ו ל מ
עולם־האמת	ע ו ל מ ה א מ ת
עולם־השקר	ע ו ל מ ה ש ק ר
עולם־ומלואו	ע ו ל מ ו מ ל ו א ו
עוף	ע ו ף
עזות'דיג	ע ז ו ת ד י ג
עזות'קייט	ע ז ו ת ק י י ט
עט	ע ט
עטוואס	ע ט ו ו א ס
עטליכע	ע ט ל י כ ע
עטרה	ע ט ר ה
עטרות	ע ט ר ו ת
עין־הרע	ע י נ ה ר ע
עיפוש	ע י פ ו ש
עיקר	ע י ק ר
עיקר־רעכן־מייסטער	ע י ק ר ר ע כ נ מ י י ס ט ע ר
עיקר־שותף	ע י ק ר ש ו ת ף
עך	ע כ
על־כל־פנים	ע ל כ ל פ נ י מ
על־כן	ע ל כ נ
על־פי	ע ל פ י
עלטסטע	ע ל ט ס ט ע
עלטסטער	ע ל ט ס ט ע ר
עלטער	ע ל ט ע ר
עלטערן	ע ל ט ע ר נ
עלטערע	ע ל ט ע ר ע
עלטערער	ע ל ט ע ר ע ר
עליה־השלום	ע ל י ה ה ש ל ו מ
עליו־השלום	ע ל י ו ה ש ל ו מ
עליכם־שלום	ע ל י כ מ ש ל ו מ
עלינו	ע ל י נ ו
עלנבויגן	ע ל נ ב ו י ג נ
עלנבויגנס	ע ל נ ב ו י ג נ ס
עלנט	ע ל נ ט
עלנטע	ע ל נ ט ע
עלעהיי	ע ל ע ה י י
עלעס־האשאכער	ע ל ע ס ה א ש א כ ע ר
עלף	ע ל ף
עמוד	ע מ ו ד
עמיצן	ע מ י צ נ
עמיצער	ע מ י צ ע ר
עמעץ	ע מ ע צ
עמער	ע מ ע ר
עמער־פלוימען	ע מ ע ר פ ל ו י מ ע נ
עמערליך	ע מ ע ר ל י כ
עמערס	ע מ ע ר ס
ענג	ע נ ג
ענגליש	ע נ ג ל י ש
ענגלישן	ע נ ג ל י ש נ
ענגלישער	ע נ ג ל י ש ע ר
ענגלען	ע נ ג ל ע נ
ענגשאפט	ע נ ג ש א פ ט
ענדיג	ע נ ד י ג
ענדיגט	ע נ ד י ג ט
ענדיגן	ע נ ד י ג נ
ענדליך	ע נ ד ל י כ
ענדערונג	ע נ ד ע ר ו נ ג
ענדערונגען	ע נ ד ע ר ו נ ג ע נ
ענוו	ע נ ו ו
ענטפער	ע נ ט פ ע ר
ענטפערט	ע נ ט פ ע ר ט
ענטפערן	ע נ ט פ ע ר נ
ענטפערנדיג	ע נ ט פ ע ר נ ד י ג
ענין	ע נ י נ
ענינים	ע נ י נ י מ
עס	ע ס
עסט	ע ס ט
עסיג	ע ס י ג
עסן	ע ס נ
עסנדיג	ע ס נ ד י ג
עסערס	ע ס ע ר ס
עסק	ע ס ק
עסשטוב	ע ס ש ט ו ב
עע	ע ע
עע־הע־הע	ע ע ה ע ה ע
עעע	ע ע ע
עפל	ע פ ל
עפל־געשמאק	ע פ ל ג ע ש מ א ק
עפלאיד	ע פ ל א י ד
עפן	ע פ נ
עפנט	ע פ נ ט
עפעלע	ע פ ע ל ע
עפענען	ע פ ע נ ע נ
עפעס	ע פ ע ס
עפשטיין	ע פ ש ט י י נ
עפשטיינען	ע פ ש ט י י נ ע נ
עצה	ע צ ה
עצות	ע צ ו ת
עק	ע ק
עקאנאמישע	ע ק א נ א מ י ש ע
עקדישן	ע ק ד י ש נ
עקזיסטירסט	ע ק ז י ס ט י ר ס ט
עקט	ע ק ט
עקן	ע ק נ
עקסטרא	ע ק ס ט ר א
עקספעדירט	ע ק ס פ ע ד י ר ט
עקספראפריאציעס	ע ק ס פ ר א פ ר י א צ י ע ס
עקרות	ע ק ר ו ת
עקשן	ע ק ש נ
ער	ע ר
ערב	ע ר ב
ערב־פסח	ע ר ב פ ס ח
ערב־שבת	ע ר ב ש ב ת
ערגעץ	ע ר ג ע צ
ערגער	ע ר ג ע ר
ערגערן	ע ר ג ע ר נ
ערד	ע ר ד
ערדפלעקן	ע ר ד פ ל ע ק נ
ערוועקן	ע ר ו ו ע ק נ
ערטער	ע ר ט ע ר
ערל	ע ר ל
ערלויבט	ע ר ל ו י ב ט
ערליכע	ע ר ל י כ ע
ערליכער	ע ר ל י כ ע ר
ערלית	ע ר ל י ת
ערנסט	ע ר נ ס ט
ערנסטן	ע ר נ ס ט נ
ערנסטע	ע ר נ ס ט ע
ערנסטקייט	ע ר נ ס ט ק י י ט
ערפילט	ע ר פ י ל ט
ערפילן	ע ר פ י ל נ
ערפרישט	ע ר פ ר י ש ט
ערקוויגט	ע ר ק ו ו י ג ט
ערשט	ע ר ש ט
ערשטן	ע ר ש ט נ
ערשטנס	ע ר ש ט נ ס
ערשטע	ע ר ש ט ע
ערשטער	ע ר ש ט ע ר
פא	פ א
פאב־שמאב	פ א ב ש מ א ב
פאבריקע	פ א ב ר י ק ע
פאגראם	פ א ג ר א מ
פאדלאגע	פ א ד ל א ג ע
פאדעם	פ א ד ע מ
פאדערט	פ א ד ע ר ט
פאדערשטן	פ א ד ע ר ש ט נ
פאדקאוועס	פ א ד ק א ו ו ע ס
פאדריאטשיק	פ א ד ר י א ט ש י ק
פאהלעך	פ א ה ל ע כ
פאוואלינקע	פ א ו ו א ל י נ ק ע
פאוואליע	פ א ו ו א ל י ע
פאווידלע	פ א ו ו י ד ל ע
פאות	פ א ו ת
פאזוכעס	פ א ז ו כ ע ס
פאזע	פ א ז ע
פאטאגראפיע	פ א ט א ג ר א פ י ע
פאטעפאלנעסט	פ א ט ע פ א ל נ ע ס ט
פאטער	פ א ט ע ר
פאטערס	פ א ט ע ר ס
פאטערשטול	פ א ט ע ר ש ט ו ל
פאטש	פ א ט ש
פאטשט	פ א ט ש ט
פאטשיילע	פ א ט ש י י ל ע
פאטשיילקעס	פ א ט ש י י ל ק ע ס
פאטשן	פ א ט ש נ
פאטשקען	פ א ט ש ק ע נ
פאכט	פ א כ ט
פאכיר	פ א כ י ר
פאכען	פ א כ ע נ
פאכערדיגע	פ א כ ע ר ד י ג ע
פאל	פ א ל
פאל־	פ א ל
פאלאנט	פ א ל א נ ט
פאלאץ	פ א ל א צ
פאלג	פ א ל ג
פאלגן	פ א ל ג נ
פאלד	פ א ל ד
פאלדן	פ א ל ד נ
פאלט	פ א ל ט
פאלטא	פ א ל ט א
פאלטאס	פ א ל ט א ס
פאלטן	פ א ל ט נ
פאליאסקע	פ א ל י א ס ק ע
פאליציי	פ א ל י צ י י
פאליציע	פ א ל י צ י ע
פאליצע	פ א ל י צ ע
פאלן	פ א ל נ
פאלניש	פ א ל נ י ש
פאלע	פ א ל ע
פאלעס	פ א ל ע ס
פאלק	פ א ל ק
פאלשע	פ א ל ש ע
פאמאיעס	פ א מ א י ע ס
פאמיליע	פ א מ י ל י ע
פאמיליעס	פ א מ י ל י ע ס
פאמעליך	פ א מ ע ל י כ
פאמעליכן	פ א מ ע ל י כ נ
פאמעניצע	פ א מ ע נ י צ ע
פאן	פ א נ
פאנטאזירן	פ א נ ט א ז י ר נ
פאנטאפעליך	פ א נ ט א פ ע ל י כ
פאניע	פ א נ י ע
פאס	פ א ס
פאס־	פ א ס
פאסט	פ א ס ט
פאסטן	פ א ס ט נ
פאסיג	פ א ס י ג
פאסעליוושייסיא	פ א ס ע ל י ו ו ש י י ס י א
פאסעס	פ א ס ע ס
פאסעסאר	פ א ס ע ס א ר
פאסעק	פ א ס ע ק
פאסקודנע	פ א ס ק ו ד נ ע
פאסקעליך	פ א ס ק ע ל י כ
פאעזיע	פ א ע ז י ע
פאפיר	פ א פ י ר
פאפיראסן	פ א פ י ר א ס נ
פאפירן	פ א פ י ר נ
פאפירעלעך	פ א פ י ר ע ל ע כ
פאפערילע	פ א פ ע ר י ל ע
פאפראווקע	פ א פ ר א ו ו ק ע
פאק	פ א ק
פאקוסן	פ א ק ו ס נ
פאקט	פ א ק ט
פאקטן	פ א ק ט נ
פאקלדיגע	פ א ק ל ד י ג ע
פאקן־טרעגער	פ א ק נ ט ר ע ג ע ר
פאר	פ א ר
פאר'חתמ'עטן	פ א ר ח ת מ ע ט נ
פאר־	פ א ר
פאר־פורים־טאג	פ א ר פ ו ר י מ ט א ג
פאר־פסח	פ א ר פ ס ח
פאראד	פ א ר א ד
פאראומערט	פ א ר א ו מ ע ר ט
פאראומערן	פ א ר א ו מ ע ר נ
פאראיבל	פ א ר א י ב ל
פארבארגענע	פ א ר ב א ר ג ע נ ע
פארבונדן	פ א ר ב ו נ ד נ
פארביי	פ א ר ב י י
פארבייגעפלויגן	פ א ר ב י י ג ע פ ל ו י ג נ
פארבלאזן	פ א ר ב ל א ז נ
פארבלאטיקטע	פ א ר ב ל א ט י ק ט ע
פארבלאנדזשעט	פ א ר ב ל א נ ד ז ש ע ט
פארבליבן	פ א ר ב ל י ב נ
פארבלענדט	פ א ר ב ל ע נ ד ט
פארבן	פ א ר ב נ
פארבעטן	פ א ר ב ע ט נ
פארבראכט	פ א ר ב ר א כ ט
פארברעכט	פ א ר ב ר ע כ ט
פארברענגט	פ א ר ב ר ע נ ג ט
פארברענגען	פ א ר ב ר ע נ ג ע נ
פארברענט	פ א ר ב ר ע נ ט
פארגאפט	פ א ר ג א פ ט
פארגינט	פ א ר ג י נ ט
פארגלוסט	פ א ר ג ל ו ס ט
פארגלייזט	פ א ר ג ל י י ז ט
פארגלייזנדיג	פ א ר ג ל י י ז נ ד י ג
פארגלייכן	פ א ר ג ל י י כ נ
פארגעניגן	פ א ר ג ע נ י ג נ
פארגעס	פ א ר ג ע ס
פארגעסן	פ א ר ג ע ס נ
פארגעסנדיג	פ א ר ג ע ס נ ד י ג
פארגעסענע	פ א ר ג ע ס ע נ ע
פארגעסענעס	פ א ר ג ע ס ע נ ע ס
פארגעסענער	פ א ר ג ע ס ע נ ע ר
פארדין	פ א ר ד י נ
פארדינט	פ א ר ד י נ ט
פארדינסט	פ א ר ד י נ ס ט
פארדינען	פ א ר ד י נ ע נ
פארדעקטן	פ א ר ד ע ק ט נ
פארדראסן	פ א ר ד ר א ס נ
פארדרייט	פ א ר ד ר י י ט
פארדרייטן	פ א ר ד ר י י ט נ
פארדרייען	פ א ר ד ר י י ע נ
פארדריסט	פ א ר ד ר י ס ט
פארדריפעטע	פ א ר ד ר י פ ע ט ע
פארהאלטן	פ א ר ה א ל ט נ
פארהאן	פ א ר ה א נ
פארהאנגען	פ א ר ה א נ ג ע נ
פארהאנדלט	פ א ר ה א נ ד ל ט
פארהוילן	פ א ר ה ו י ל נ
פארהוסטן	פ א ר ה ו ס ט נ
פארהייזל	פ א ר ה י י ז ל
פארהילט	פ א ר ה י ל ט
פארהערט	פ א ר ה ע ר ט
פארהערן	פ א ר ה ע ר נ
פארוואגלט	פ א ר ו ו א ג ל ט
פארוואונדערט	פ א ר ו ו א ו נ ד ע ר ט
פארוואס	פ א ר ו ו א ס
פארווארפט	פ א ר ו ו א ר פ ט
פארווארפן	פ א ר ו ו א ר פ נ
פארווארפענע	פ א ר ו ו א ר פ ע נ ע
פארוויקלט	פ א ר ו ו י ק ל ט
פארויס	פ א ר ו י ס
פארזאמלט	פ א ר ז א מ ל ט
פארזארגט	פ א ר ז א ר ג ט
פארזארגן	פ א ר ז א ר ג נ
פארזוכט	פ א ר ז ו כ ט
פארזוכן	פ א ר ז ו כ נ
פארזונקען	פ א ר ז ו נ ק ע נ
פארזיכטיג	פ א ר ז י כ ט י ג
פארזינדיג	פ א ר ז י נ ד י ג
פארזינדיגן	פ א ר ז י נ ד י ג נ
פארזעצן	פ א ר ז ע צ נ
פארט	פ א ר ט
פארטא	פ א ר ט א
פארטאג	פ א ר ט א ג
פארטאגס	פ א ר ט א ג ס
פארטאן	פ א ר ט א נ
פארטארעראמעט	פ א ר ט א ר ע ר א מ ע ט
פארטוישן	פ א ר ט ו י ש נ
פארטוך	פ א ר ט ו כ
פארטומלטער	פ א ר ט ו מ ל ט ע ר
פארטומלען	פ א ר ט ו מ ל ע נ
פארטון	פ א ר ט ו נ
פארטונקט	פ א ר ט ו נ ק ט
פארטונקען	פ א ר ט ו נ ק ע נ
פארטיג	פ א ר ט י ג
פארטיגער	פ א ר ט י ג ע ר
פארטיפן	פ א ר ט י פ נ
פארטעך	פ א ר ט ע כ
פארטקע	פ א ר ט ק ע
פארטראכט	פ א ר ט ר א כ ט
פארטרויט	פ א ר ט ר ו י ט
פארטרונקען	פ א ר ט ר ו נ ק ע נ
פארטרייב	פ א ר ט ר י י ב
פארטרינקט	פ א ר ט ר י נ ק ט
פארטרינקען	פ א ר ט ר י נ ק ע נ
פארטשעפע	פ א ר ט ש ע פ ע
פאריאגן	פ א ר י א ג נ
פארכאפט	פ א ר כ א פ ט
פארל	פ א ר ל
פארלאז	פ א ר ל א ז
פארלאזט	פ א ר ל א ז ט
פארלאזטע	פ א ר ל א ז ט ע
פארלאזן	פ א ר ל א ז נ
פארלאנג	פ א ר ל א נ ג
פארלאנגט	פ א ר ל א נ ג ט
פארלאנגען	פ א ר ל א נ ג ע נ
פארלאפן	פ א ר ל א פ נ
פארלוירן	פ א ר ל ו י ר נ
פארליבט	פ א ר ל י ב ט
פארלייגט	פ א ר ל י י ג ט
פארלירן	פ א ר ל י ר נ
פארלעגער	פ א ר ל ע ג ע ר
פארמאג	פ א ר מ א ג
פארמאגט	פ א ר מ א ג ט
פארמאגן	פ א ר מ א ג נ
פארמאכט	פ א ר מ א כ ט
פארמע	פ א ר מ ע
פארמעגן	פ א ר מ ע ג נ
פארמשפט	פ א ר מ ש פ ט
פארן	פ א ר נ
פארנאכט	פ א ר נ א כ ט
פארנאכטליך	פ א ר נ א כ ט ל י כ
פארנאכטן	פ א ר נ א כ ט נ
פארנארן	פ א ר נ א ר נ
פארנדיג	פ א ר נ ד י ג
פארנומען	פ א ר נ ו מ ע נ
פארנט	פ א ר נ ט
פארניכטן	פ א ר נ י כ ט נ
פארסאפעט	פ א ר ס א פ ע ט
פארסטו	פ א ר ס ט ו
פארסמטע	פ א ר ס מ ט ע
פארע	פ א ר ע
פארעווען	פ א ר ע ו ו ע נ
פארעם	פ א ר ע מ
פארענטפערט	פ א ר ע נ ט פ ע ר ט
פארענטפערן	פ א ר ע נ ט פ ע ר נ
פארפאלן	פ א ר פ א ל נ
פארפאלענע	פ א ר פ א ל ע נ ע
פארפאסער	פ א ר פ א ס ע ר
פארפאסקודיגט	פ א ר פ א ס ק ו ד י ג ט
פארפאקט	פ א ר פ א ק ט
פארפארן	פ א ר פ א ר נ
פארפוילט	פ א ר פ ו י ל ט
פארפולט	פ א ר פ ו ל ט
פארפונדעוועט	פ א ר פ ו נ ד ע ו ו ע ט
פארפינצטערט	פ א ר פ י נ צ ט ע ר ט
פארפירן	פ א ר פ י ר נ
פארפלאכטן	פ א ר פ ל א כ ט נ
פארפלאמט	פ א ר פ ל א מ ט
פארפלאנטעוועט	פ א ר פ ל א נ ט ע ו ו ע ט
פארפלאנטערט	פ א ר פ ל א נ ט ע ר ט
פארפלייצן	פ א ר פ ל י י צ נ
פארפעסטיגט	פ א ר פ ע ס ט י ג ט
פארפרוירן	פ א ר פ ר ו י ר נ
פארפרוירענעם	פ א ר פ ר ו י ר ע נ ע מ
פארצארעט	פ א ר צ א ר ע ט
פארצוקט	פ א ר צ ו ק ט
פארציט	פ א ר צ י ט
פארצערן	פ א ר צ ע ר נ
פארק	פ א ר ק
פארקאוועטן	פ א ר ק א ו ו ע ט נ
פארקאטשע	פ א ר ק א ט ש ע
פארקאן	פ א ר ק א נ
פארקויפט	פ א ר ק ו י פ ט
פארקויפן	פ א ר ק ו י פ נ
פארקומען	פ א ר ק ו מ ע נ
פארקייטלען	פ א ר ק י י ט ל ע נ
פארקילונג	פ א ר ק י ל ו נ ג
פארקילן	פ א ר ק י ל נ
פארקלאגט	פ א ר ק ל א ג ט
פארקלאפט	פ א ר ק ל א פ ט
פארקלעמט	פ א ר ק ל ע מ ט
פארקלערט	פ א ר ק ל ע ר ט
פארקנאטן	פ א ר ק נ א ט נ
פארקנייטשט	פ א ר ק נ י י ט ש ט
פארקעמט	פ א ר ק ע מ ט
פארקערט	פ א ר ק ע ר ט
פארקראכן	פ א ר ק ר א כ נ
פארקריכן	פ א ר ק ר י כ נ
פארקרימט	פ א ר ק ר י מ ט
פארקרימטע	פ א ר ק ר י מ ט ע
פאררוקט	פ א ר ר ו ק ט
פאררוקן	פ א ר ר ו ק נ
פארריכט	פ א ר ר י כ ט
פארריסן	פ א ר ר י ס נ
פאררעדט	פ א ר ר ע ד ט
פארשאטן	פ א ר ש א ט נ
פארשאלטן	פ א ר ש א ל ט נ
פארשוואונדן	פ א ר ש ו ו א ו נ ד נ
פארשווארצט	פ א ר ש ו ו א ר צ ט
פארשווינדט	פ א ר ש ו ו י נ ד ט
פארשווינדן	פ א ר ש ו ו י נ ד נ
פארשוויצט	פ א ר ש ו ו י צ ט
פארשוויצטער	פ א ר ש ו ו י צ ט ע ר
פארשוין	פ א ר ש ו י נ
פארשוינען	פ א ר ש ו י נ ע נ
פארשטאנד	פ א ר ש ט א נ ד
פארשטאנען	פ א ר ש ט א נ ע נ
פארשטארט	פ א ר ש ט א ר ט
פארשטומט	פ א ר ש ט ו מ ט
פארשטומען	פ א ר ש ט ו מ ע נ
פארשטיי	פ א ר ש ט י י
פארשטייט	פ א ר ש ט י י ט
פארשטיין	פ א ר ש ט י י נ
פארשטייענדיג	פ א ר ש ט י י ע נ ד י ג
פארשטעלט	פ א ר ש ט ע ל ט
פארשטעלטער	פ א ר ש ט ע ל ט ע ר
פארשטעלן	פ א ר ש ט ע ל נ
פארשטעקט	פ א ר ש ט ע ק ט
פארשטערט	פ א ר ש ט ע ר ט
פארשידענע	פ א ר ש י ד ע נ ע
פארשילטן	פ א ר ש י ל ט נ
פארשימלט	פ א ר ש י מ ל ט
פארשלאגן	פ א ר ש ל א ג נ
פארשלאסן	פ א ר ש ל א ס נ
פארשלאפן	פ א ר ש ל א פ נ
פארשלאפענעם	פ א ר ש ל א פ ע נ ע מ
פארשליס	פ א ר ש ל י ס
פארשליסט	פ א ר ש ל י ס ט
פארשליסן	פ א ר ש ל י ס נ
פארשמירט	פ א ר ש מ י ר ט
פארשמירטע	פ א ר ש מ י ר ט ע
פארשנייט	פ א ר ש נ י י ט
פארשעמט	פ א ר ש ע מ ט
פארשעמטן	פ א ר ש ע מ ט נ
פארשעמטערהייט	פ א ר ש ע מ ט ע ר ה י י ט
פארשפאלטן	פ א ר ש פ א ל ט נ
פארשפארט	פ א ר ש פ א ר ט
פארשפילט	פ א ר ש פ י ל ט
פארשפעטיקן	פ א ר ש פ ע ט י ק נ
פארשפרייט	פ א ר ש פ ר י י ט
פארשפרייטן	פ א ר ש פ ר י י ט נ
פארשריבן	פ א ר ש ר י ב נ
פארשרייבט	פ א ר ש ר י י ב ט
פארשרייבן	פ א ר ש ר י י ב נ
פאשע	פ א ש ע
פגרן	פ ג ר נ
פדיון	פ ד י ו נ
פובליקום	פ ו ב ל י ק ו מ
פוד	פ ו ד
פוטער	פ ו ט ע ר
פוטער־בולקעס	פ ו ט ע ר ב ו ל ק ע ס
פוטער־געבעקס	פ ו ט ע ר ג ע ב ע ק ס
פוטער־געבעקסל	פ ו ט ע ר ג ע ב ע ק ס ל
פוטער־געבעקסלעך	פ ו ט ע ר ג ע ב ע ק ס ל ע כ
פוטערברויט	פ ו ט ע ר ב ר ו י ט
פוטערן	פ ו ט ע ר נ
פוטערנעם	פ ו ט ע ר נ ע מ
פויגל	פ ו י ג ל
פויגלען	פ ו י ג ל ע נ
פויגעליך	פ ו י ג ע ל י כ
פויזשעט	פ ו י ז ש ע ט
פוילט	פ ו י ל ט
פויליש	פ ו י ל י ש
פוילן	פ ו י ל נ
פויסט	פ ו י ס ט
פויער	פ ו י ע ר
פויערים	פ ו י ע ר י מ
פויעריש	פ ו י ע ר י ש
פויערישן	פ ו י ע ר י ש נ
פויערישע	פ ו י ע ר י ש ע
פויערן	פ ו י ע ר נ
פויערס	פ ו י ע ר ס
פול	פ ו ל
פולן	פ ו ל נ
פולע	פ ו ל ע
פולער	פ ו ל ע ר
פון	פ ו נ
פונאנדערגעלאזענע	פ ו נ א נ ד ע ר ג ע ל א ז ע נ ע
פונדעסטוועגן	פ ו נ ד ע ס ט ו ו ע ג נ
פונעם	פ ו נ ע מ
פונק	פ ו נ ק
פונקט	פ ו נ ק ט
פונקען	פ ו נ ק ע נ
פוס	פ ו ס
פוסגייער	פ ו ס ג י י ע ר
פוסטן	פ ו ס ט נ
פוסטע	פ ו ס ט ע
פוסנס	פ ו ס נ ס
פוסקים	פ ו ס ק י מ
פועלן	פ ו ע ל נ
פופיג	פ ו פ י ג
פופציג	פ ו פ צ י ג
פופצן	פ ו פ צ נ
פופצן־צוואנציג	פ ו פ צ נ צ ו ו א נ צ י ג
פור	פ ו ר
פורים	פ ו ר י מ
פורים־קוילעטש	פ ו ר י מ ק ו י ל ע ט ש
פורים־שפילער	פ ו ר י מ ש פ י ל ע ר
פורקאנייא	פ ו ר ק א נ י י א
פושע־ישראל	פ ו ש ע י ש ר א ל
פושער	פ ו ש ע ר
פחד	פ ח ד
פטור	פ ט ו ר
פי	פ י
פיאווקע	פ י א ו ו ק ע
פיאווקעס	פ י א ו ו ק ע ס
פידל	פ י ד ל
פידעליך	פ י ד ע ל י כ
פידעלע	פ י ד ע ל ע
פיזמון	פ י ז מ ו נ
פיזמונות	פ י ז מ ו נ ו ת
פיטום־הקטורת	פ י ט ו מ ה ק ט ו ר ת
פיטערן	פ י ט ע ר נ
פיטשעווקעס	פ י ט ש ע ו ו ק ע ס
פייגלעך	פ י י ג ל ע כ
פייגע־לאה	פ י י ג ע ל א ה
פייטלען	פ י י ט ל ע נ
פייכטע	פ י י כ ט ע
פייל	פ י י ל
פיילן־בויגנס	פ י י ל נ ב ו י ג נ ס
פיין	פ י י נ
פיין־פין	פ י י נ פ י נ
פיין־פין־פיין	פ י י נ פ י נ פ י י נ
פיינדע	פ י י נ ד ע
פיינט	פ י י נ ט
פיינטשיג	פ י י נ ט ש י ג
פיינע	פ י י נ ע
פיינער	פ י י נ ע ר
פיינפינקלקרויט	פ י י נ פ י נ ק ל ק ר ו י ט
פיינשמעקער	פ י י נ ש מ ע ק ע ר
פייסי	פ י י ס י
פייער	פ י י ע ר
פייער־קנאקן	פ י י ע ר ק נ א ק נ
פייערדיג	פ י י ע ר ד י ג
פייערדיגן	פ י י ע ר ד י ג נ
פייערדיגע	פ י י ע ר ד י ג ע
פייערט	פ י י ע ר ט
פייערל	פ י י ע ר ל
פייערן	פ י י ע ר נ
פייערפלאם	פ י י ע ר פ ל א מ
פייערקע	פ י י ע ר ק ע
פייפער	פ י י פ ע ר
פיל	פ י ל
פילדערן	פ י ל ד ע ר נ
פילט	פ י ל ט
פיליער	פ י ל י ע ר
פילן	פ י ל נ
פילנדיג	פ י ל נ ד י ג
פין־פיין־פין	פ י נ פ י י נ פ י נ
פינאנץ־מיניסטער	פ י נ א נ צ מ י נ י ס ט ע ר
פינגער	פ י נ ג ע ר
פינגערל	פ י נ ג ע ר ל
פינגערלעך	פ י נ ג ע ר ל ע כ
פינטלט	פ י נ ט ל ט
פינטעלעך	פ י נ ט ע ל ע כ
פיניע	פ י נ י ע
פינסטער	פ י נ ס ט ע ר
פינסטערן	פ י נ ס ט ע ר נ
פינסטערניש	פ י נ ס ט ע ר נ י ש
פינסטערער	פ י נ ס ט ע ר ע ר
פינעף	פ י נ ע ף
פינף	פ י נ ף
פינף־און־זיבעציג	פ י נ ף א ו נ ז י ב ע צ י ג
פינף־זעקס	פ י נ ף ז ע ק ס
פינפערל	פ י נ פ ע ר ל
פינקלט	פ י נ ק ל ט
פינקלען	פ י נ ק ל ע נ
פיס	פ י ס
פיסל	פ י ס ל
פיסלעך	פ י ס ל ע כ
פיסק	פ י ס ק
פיסקעלעך	פ י ס ק ע ל ע כ
פיעסע	פ י ע ס ע
פיצל	פ י צ ל
פיקן	פ י ק נ
פיר	פ י ר
פיר־און־זיבעציג	פ י ר א ו נ ז י ב ע צ י ג
פיר־עקנדיגן	פ י ר ע ק נ ד י ג נ
פיר־קאנטיגן	פ י ר ק א נ ט י ג נ
פירוש	פ י ר ו ש
פירות	פ י ר ו ת
פירט	פ י ר ט
פירמע	פ י ר מ ע
פירן	פ י ר נ
פירקאנטיג	פ י ר ק א נ ט י ג
פיש	פ י ש
פישטשאלקע	פ י ש ט ש א ל ק ע
פישערס	פ י ש ע ר ס
פלאטערט	פ ל א ט ע ר ט
פלאכטע	פ ל א כ ט ע
פלאם	פ ל א מ
פלאמען	פ ל א מ ע נ
פלאן	פ ל א נ
פלאץ	פ ל א צ
פלאצט	פ ל א צ ט
פלאצן	פ ל א צ נ
פלאצקער	פ ל א צ ק ע ר
פלאקערט	פ ל א ק ע ר ט
פלאש	פ ל א ש
פלו־	פ ל ו
פלודערן	פ ל ו ד ע ר נ
פלויט	פ ל ו י ט
פלוים	פ ל ו י מ
פלוימען	פ ל ו י מ ע נ
פלוס	פ ל ו ס
פלוצלונג	פ ל ו צ ל ו נ ג
פלוצלינג	פ ל ו צ ל י נ ג
פלוצעם	פ ל ו צ ע מ
פלי	פ ל י
פליאמע	פ ל י א מ ע
פליאסקעט	פ ל י א ס ק ע ט
פליגל	פ ל י ג ל
פליגלען	פ ל י ג ל ע נ
פליגן	פ ל י ג נ
פליגעליך	פ ל י ג ע ל י כ
פליט	פ ל י ט
פליטה	פ ל י ט ה
פליין	פ ל י י נ
פלייס	פ ל י י ס
פלייצע	פ ל י י צ ע
פלייצעס	פ ל י י צ ע ס
פלייש	פ ל י י ש
פליישיג	פ ל י י ש י ג
פליישיגן	פ ל י י ש י ג נ
פליישיגע	פ ל י י ש י ג ע
פלינק	פ ל י נ ק
פלינקער	פ ל י נ ק ע ר
פליסטו	פ ל י ס ט ו
פליען	פ ל י ע נ
פליעסק	פ ל י ע ס ק
פלעג	פ ל ע ג
פלעגט	פ ל ע ג ט
פלעגן	פ ל ע ג נ
פלעווע	פ ל ע ו ו ע
פלעכטלעך	פ ל ע כ ט ל ע כ
פלעכטן	פ ל ע כ ט נ
פלעצער	פ ל ע צ ע ר
פלעק	פ ל ע ק
פלעקט	פ ל ע ק ט
פלעשל	פ ל ע ש ל
פלעשלעך	פ ל ע ש ל ע כ
פלעשלעכווייז	פ ל ע ש ל ע כ ו ו י י ז
פלעשעלע	פ ל ע ש ע ל ע
פלעשעלעך	פ ל ע ש ע ל ע כ
פלעשער	פ ל ע ש ע ר
פנים	פ נ י מ
פנימל	פ נ י מ ל
פנימער	פ נ י מ ע ר
פסול	פ ס ו ל
פסוק	פ ס ו ק
פסח	פ ס ח
פסח'דיגער	פ ס ח ד י ג ע ר
פסיכאלאגישע	פ ס י כ א ל א ג י ש ע
פסק	פ ס ק
פסקנט	פ ס ק נ ט
פסקענען	פ ס ק ע נ ע נ
פעדער	פ ע ד ע ר
פעדערל	פ ע ד ע ר ל
פעדערלעך	פ ע ד ע ר ל ע כ
פעדערן	פ ע ד ע ר נ
פעווראלסקע־רעוואלוציע	פ ע ו ו ר א ל ס ק ע ר ע ו ו א ל ו צ י ע
פעטע	פ ע ט ע
פעטעלעלע	פ ע ט ע ל ע ל ע
פעטער	פ ע ט ע ר
פעטש	פ ע ט ש
פעך	פ ע כ
פעל	פ ע ל
פעלד	פ ע ל ד
פעלדבלומען	פ ע ל ד ב ל ו מ ע נ
פעלדער	פ ע ל ד ע ר
פעלז	פ ע ל ז
פעלט	פ ע ל ט
פעלן	פ ע ל נ
פעלץ	פ ע ל צ
פעלצל	פ ע ל צ ל
פעלצלעך	פ ע ל צ ל ע כ
פעלצן	פ ע ל צ נ
פען	פ ע נ
פענסטער	פ ע נ ס ט ע ר
פענסטערל	פ ע נ ס ט ע ר ל
פענסטערליך	פ ע נ ס ט ע ר ל י כ
פעסט	פ ע ס ט
פעסיע	פ ע ס י ע
פעסיען	פ ע ס י ע נ
פעסיעס	פ ע ס י ע ס
פעסל	פ ע ס ל
פעפער	פ ע פ ע ר
פעק	פ ע ק
פעקל	פ ע ק ל
פעקלעך	פ ע ק ל ע כ
פעראנדעק	פ ע ר א נ ד ע ק
פערד	פ ע ר ד
פערדיונגס	פ ע ר ד י ו נ ג ס
פערדל	פ ע ר ד ל
פערדלס	פ ע ר ד ל ס
פערדלעך	פ ע ר ד ל ע כ
פערדמארק	פ ע ר ד מ א ר ק
פערדס	פ ע ר ד ס
פערדעלע	פ ע ר ד ע ל ע
פערזאנען	פ ע ר ז א נ ע נ
פערטל	פ ע ר ט ל
פערטן	פ ע ר ט נ
פערי	פ ע ר י
פערל	פ ע ר ל
פערסישע	פ ע ר ס י ש ע
פערציג	פ ע ר צ י ג
פערציג־פופציג	פ ע ר צ י ג פ ו פ צ י ג
פערצנטער	פ ע ר צ נ ט ע ר
פערשקע	פ ע ר ש ק ע
פערשקעס	פ ע ר ש ק ע ס
פראבירן	פ ר א ב י ר נ
פראבן	פ ר א ב נ
פראבע	פ ר א ב ע
פראבקעס	פ ר א ב ק ע ס
פראגן	פ ר א ג נ
פראגע	פ ר א ג ע
פראוויאנט	פ ר א ו ו י א נ ט
פראטעסט	פ ר א ט ע ס ט
פראנצויזיש	פ ר א נ צ ו י ז י ש
פראנק	פ ר א נ ק
פראסט	פ ר א ס ט
פראסטן	פ ר א ס ט נ
פראסטע	פ ר א ס ט ע
פראסטער	פ ר א ס ט ע ר
פראסק	פ ר א ס ק
פראפעסאר	פ ר א פ ע ס א ר
פראצענט	פ ר א צ ע נ ט
פראקטיקע	פ ר א ק ט י ק ע
פראשעניעס	פ ר א ש ע נ י ע ס
פראשעק	פ ר א ש ע ק
פראשקעס	פ ר א ש ק ע ס
פרואוו	פ ר ו א ו ו
פרואווט	פ ר ו א ו ו ט
פרואוון	פ ר ו א ו ו נ
פרוטה	פ ר ו ט ה
פרוי	פ ר ו י
פרוכט	פ ר ו כ ט
פרום	פ ר ו מ
פרומע	פ ר ו מ ע
פרומער	פ ר ו מ ע ר
פרוש	פ ר ו ש
פרי	פ ר י
פרידן	פ ר י ד נ
פריזיוו	פ ר י ז י ו ו
פריטשעפע	פ ר י ט ש ע פ ע
פריי	פ ר י י
פרייד	פ ר י י ד
פרייז	פ ר י י ז
פרייט	פ ר י י ט
פרייטאג	פ ר י י ט א ג
פרייטאג־צו־נאכטס	פ ר י י ט א ג צ ו נ א כ ט ס
פרייליך	פ ר י י ל י כ
פרייליכן	פ ר י י ל י כ נ
פרייליכע	פ ר י י ל י כ ע
פרייליכער	פ ר י י ל י כ ע ר
פריינדליך	פ ר י י נ ד ל י כ
פריינדליכע	פ ר י י נ ד ל י כ ע
פריינדשאפט	פ ר י י נ ד ש א פ ט
פריינט	פ ר י י נ ט
פרייע	פ ר י י ע
פרייען	פ ר י י ע נ
פרייער	פ ר י י ע ר
פרילינג	פ ר י ל י נ ג
פרילינגנאכט	פ ר י ל י נ ג נ א כ ט
פרילינגס־מארגן	פ ר י ל י נ ג ס מ א ר ג נ
פרילינגסטאג	פ ר י ל י נ ג ס ט א ג
פרימאדאנע	פ ר י מ א ד א נ ע
פרימארגן	פ ר י מ א ר ג נ
פרימארגנדיגע	פ ר י מ א ר ג נ ד י ג ע
פרינץ	פ ר י נ צ
פרינציפיעלער	פ ר י נ צ י פ י ע ל ע ר
פרינצעסין	פ ר י נ צ ע ס י נ
פריען	פ ר י ע נ
פריער	פ ר י ע ר
פריערדיגע	פ ר י ע ר ד י ג ע
פריערדיגער	פ ר י ע ר ד י ג ע ר
פריעריגע	פ ר י ע ר י ג ע
פריץ	פ ר י צ
פריצה	פ ר י צ ה
פריצים	פ ר י צ י מ
פריציש	פ ר י צ י ש
פריצישער	פ ר י צ י ש ע ר
פריקאשטשיג	פ ר י ק א ש ט ש י ג
פרישטשיקלעך	פ ר י ש ט ש י ק ל ע כ
פרישן	פ ר י ש נ
פרישע	פ ר י ש ע
פרישער	פ ר י ש ע ר
פרנסה	פ ר נ ס ה
פרנסות	פ ר נ ס ו ת
פרעג	פ ר ע ג
פרעגט	פ ר ע ג ט
פרעגלט	פ ר ע ג ל ט
פרעגלען	פ ר ע ג ל ע נ
פרעגן	פ ר ע ג נ
פרעגנדיג	פ ר ע ג נ ד י ג
פרעזידענט	פ ר ע ז י ד ע נ ט
פרעזעס	פ ר ע ז ע ס
פרעטענזיע	פ ר ע ט ע נ ז י ע
פרעטענציע	פ ר ע ט ע נ צ י ע
פרעמד	פ ר ע מ ד
פרעמדן	פ ר ע מ ד נ
פרעמדע	פ ר ע מ ד ע
פרעמדער	פ ר ע מ ד ע ר
פרעמיערע	פ ר ע מ י ע ר ע
פרעסט	פ ר ע ס ט
פרעסנדיג	פ ר ע ס נ ד י ג
פרץ	פ ר צ
פרק	פ ר ק
פשא	פ ש א
פשוט	פ ש ו ט
פשוט'ע	פ ש ו ט ע
פשוט'ער	פ ש ו ט ע ר
צאדייקים	צ א ד י י ק י מ
צאהא	צ א ה א
צאהאלע־וועסימכע	צ א ה א ל ע ו ו ע ס י מ כ ע
צאלן	צ א ל נ
צאן	צ א נ
צאפט	צ א פ ט
צאפלט	צ א פ ל ט
צאפן	צ א פ נ
צאצקע	צ א צ ק ע
צאצקעלע	צ א צ ק ע ל ע
צאצקעס	צ א צ ק ע ס
צד	צ ד
צדיק	צ ד י ק
צדקה־טעלער	צ ד ק ה ט ע ל ע ר
צו	צ ו
צו־נאכטס	צ ו נ א כ ט ס
צו־נאכטס־רעכענונג	צ ו נ א כ ט ס ר ע כ ע נ ו נ ג
צואווארפן	צ ו א ו ו א ר פ נ
צואיילן	צ ו א י י ל נ
צוג	צ ו ג
צוגאב	צ ו ג א ב
צוגיין	צ ו ג י י נ
צוגע־	צ ו ג ע
צוגעבונדן	צ ו ג ע ב ו נ ד נ
צוגעבן	צ ו ג ע ב נ
צוגעגאנגען	צ ו ג ע ג א נ ג ע נ
צוגעגעבן	צ ו ג ע ג ע ב נ
צוגעגעסן	צ ו ג ע ג ע ס נ
צוגעגרייט	צ ו ג ע ג ר י י ט
צוגעדעקט	צ ו ג ע ד ע ק ט
צוגעזאגט	צ ו ג ע ז א ג ט
צוגעזעהן	צ ו ג ע ז ע ה נ
צוגעזעצט	צ ו ג ע ז ע צ ט
צוגעטראגן	צ ו ג ע ט ר א ג נ
צוגעטראכט	צ ו ג ע ט ר א כ ט
צוגעטשעפעט	צ ו ג ע ט ש ע פ ע ט
צוגעכאפט	צ ו ג ע כ א פ ט
צוגעלאזט	צ ו ג ע ל א ז ט
צוגעלאזטע	צ ו ג ע ל א ז ט ע
צוגעלייגט	צ ו ג ע ל י י ג ט
צוגעלעגערט	צ ו ג ע ל ע ג ע ר ט
צוגעמאכט	צ ו ג ע מ א כ ט
צוגענומען	צ ו ג ע נ ו מ ע נ
צוגעפארן	צ ו ג ע פ א ר נ
צוגעפירט	צ ו ג ע פ י ר ט
צוגעקאמפאניעט	צ ו ג ע ק א מ פ א נ י ע ט
צוגעקומען	צ ו ג ע ק ו מ ע נ
צוגעקוקט	צ ו ג ע ק ו ק ט
צוגעקילט	צ ו ג ע ק י ל ט
צוגעקליבן	צ ו ג ע ק ל י ב נ
צוגערוקט	צ ו ג ע ר ו ק ט
צוגעשאקלט	צ ו ג ע ש א ק ל ט
צוגעשטיקט	צ ו ג ע ש ט י ק ט
צוגעשטעלט	צ ו ג ע ש ט ע ל ט
צוגעשיקט	צ ו ג ע ש י ק ט
צוגעשמייכלט	צ ו ג ע ש מ י י כ ל ט
צוהאלטן	צ ו ה א ל ט נ
צוואנציג	צ ו ו א נ צ י ג
צוויטשער	צ ו ו י ט ש ע ר
צוויי	צ ו ו י י
צוויי־און־אכציג	צ ו ו י י א ו נ א כ צ י ג
צוויי־דריי	צ ו ו י י ד ר י י
צוויי־וועלטיג־אידל	צ ו ו י י ו ו ע ל ט י ג א י ד ל
צווייג	צ ו ו י י ג
צווייגל	צ ו ו י י ג ל
צווייגליך	צ ו ו י י ג ל י כ
צווייגן	צ ו ו י י ג נ
צווייגעלע	צ ו ו י י ג ע ל ע
צווייט	צ ו ו י י ט
צווייטן	צ ו ו י י ט נ
צווייטנס	צ ו ו י י ט נ ס
צווייטע	צ ו ו י י ט ע
צווייטער	צ ו ו י י ט ע ר
צווייען	צ ו ו י י ע נ
צווייער	צ ו ו י י ע ר
צווייפלען	צ ו ו י י פ ל ע נ
צווישן	צ ו ו י ש נ
צוועל	צ ו ו ע ל
צוועלף	צ ו ו ע ל ף
צוועלף־דרייצן	צ ו ו ע ל ף ד ר י י צ נ
צוזאמען	צ ו ז א מ ע נ
צוזאמענגעגאסן	צ ו ז א מ ע נ ג ע ג א ס נ
צוזאמענגעדריקט	צ ו ז א מ ע נ ג ע ד ר י ק ט
צוזאמענגעהאפטן	צ ו ז א מ ע נ ג ע ה א פ ט נ
צוזאמענגעמישט	צ ו ז א מ ע נ ג ע מ י ש ט
צוזאמענגענומען	צ ו ז א מ ע נ ג ע נ ו מ ע נ
צוזאמענגעקלאפט	צ ו ז א מ ע נ ג ע ק ל א פ ט
צוזאמענקומען	צ ו ז א מ ע נ ק ו מ ע נ
צוזעצן	צ ו ז ע צ נ
צולאג	צ ו ל א ג
צולאזן	צ ו ל א ז נ
צוליב	צ ו ל י ב
צוליבן	צ ו ל י ב נ
צולייגן	צ ו ל י י ג נ
צום	צ ו מ
צון	צ ו נ
צונג	צ ו נ ג
צונגען	צ ו נ ג ע נ
צונויף	צ ו נ ו י ף
צונויפגעבונדן	צ ו נ ו י פ ג ע ב ו נ ד נ
צונויפגעבראכט	צ ו נ ו י פ ג ע ב ר א כ ט
צונויפגעגאסן	צ ו נ ו י פ ג ע ג א ס נ
צונויפגעוואקסן	צ ו נ ו י פ ג ע ו ו א ק ס נ
צונויפגעלאפן	צ ו נ ו י פ ג ע ל א פ נ
צונויפגעלייגט	צ ו נ ו י פ ג ע ל י י ג ט
צונויפגענומען	צ ו נ ו י פ ג ע נ ו מ ע נ
צונויפלויפן	צ ו נ ו י פ ל ו י פ נ
צונעמען	צ ו נ ע מ ע נ
צונעמעניש	צ ו נ ע מ ע נ י ש
צופ	צ ו פ
צופוסנס	צ ו פ ו ס נ ס
צופט	צ ו פ ט
צופירן	צ ו פ י ר נ
צופן	צ ו פ נ
צופרידן	צ ו פ ר י ד נ
צופרידנהייט	צ ו פ ר י ד נ ה י י ט
צוצאלן	צ ו צ א ל נ
צוצוגיין	צ ו צ ו ג י י נ
צוק	צ ו ק
צוקאפנס	צ ו ק א פ נ ס
צוקער	צ ו ק ע ר
צוקער־זיס	צ ו ק ע ר ז י ס
צוקערניע	צ ו ק ע ר נ י ע
צוריק	צ ו ר י ק
צוריקגעגעבן	צ ו ר י ק ג ע ג ע ב נ
צוריקגעקומען	צ ו ר י ק ג ע ק ו מ ע נ
צוריקקומענדיג	צ ו ר י ק ק ו מ ע נ ד י ג
צושטימונג	צ ו ש ט י מ ו נ ג
צושטעלן	צ ו ש ט ע ל נ
צושיקן	צ ו ש י ק נ
צי	צ י
ציבעלעס	צ י ב ע ל ע ס
ציבעלקעליך	צ י ב ע ל ק ע ל י כ
ציג	צ י ג
ציגאר	צ י ג א ר
ציגארן	צ י ג א ר נ
ציגיינער	צ י ג י י נ ע ר
ציגיינערס	צ י ג י י נ ע ר ס
ציגל	צ י ג ל
ציוניסט	צ י ו נ י ס ט
ציט	צ י ט
ציטערדיגע	צ י ט ע ר ד י ג ע
ציטערט	צ י ט ע ר ט
ציטערן	צ י ט ע ר נ
ציטערנדיגע	צ י ט ע ר נ ד י ג ע
ציטערניש	צ י ט ע ר נ י ש
צייט	צ י י ט
צייטונגען	צ י י ט ו נ ג ע נ
צייטיגע	צ י י ט י ג ע
צייטיגער	צ י י ט י ג ע ר
צייטן	צ י י ט נ
צייכן	צ י י כ נ
ציילט	צ י י ל ט
ציין	צ י י נ
ציינדאקטער	צ י י נ ד א ק ט ע ר
ציכטיג	צ י כ ט י ג
צימוקים־וויין	צ י מ ו ק י מ ו ו י י נ
צימעס	צ י מ ע ס
צין	צ י נ
צינגל	צ י נ ג ל
צינדט	צ י נ ד ט
צינדן	צ י נ ד נ
ציען	צ י ע נ
ציפן	צ י פ נ
ציפעט	צ י פ ע ט
ציפערן	צ י פ ע ר נ
ציצה־כנפותליך	צ י צ ה כ נ פ ו ת ל י כ
ציצית	צ י צ י ת
ציקלען	צ י ק ל ע נ
צירונג	צ י ר ו נ ג
צנועהדיג	צ נ ו ע ה ד י ג
צעבלוטיקטע	צ ע ב ל ו ט י ק ט ע
צעבראכן	צ ע ב ר א כ נ
צעבראכענע	צ ע ב ר א כ ע נ ע
צעברעך	צ ע ב ר ע כ
צעברעכן	צ ע ב ר ע כ נ
צעגאנגען	צ ע ג א נ ג ע נ
צעגאנגענער	צ ע ג א נ ג ע נ ע ר
צעגאסן	צ ע ג א ס נ
צעגארטלט	צ ע ג א ר ט ל ט
צעגייט	צ ע ג י י ט
צעגיין	צ ע ג י י נ
צעגייען	צ ע ג י י ע נ
צעגיסט	צ ע ג י ס ט
צעגיסן	צ ע ג י ס נ
צעגעסן	צ ע ג ע ס נ
צעדעך־לעדערעך	צ ע ד ע כ ל ע ד ע ר ע כ
צעדרייט	צ ע ד ר י י ט
צעהאקט	צ ע ה א ק ט
צעהיצט	צ ע ה י צ ט
צעווארפענע	צ ע ו ו א ר פ ע נ ע
צעוויין	צ ע ו ו י י נ
צעוויינט	צ ע ו ו י י נ ט
צעזעצט	צ ע ז ע צ ט
צעטומלט	צ ע ט ו מ ל ט
צעטיילט	צ ע ט י י ל ט
צעטיילן	צ ע ט י י ל נ
צעטל	צ ע ט ל
צעטריבן	צ ע ט ר י ב נ
צעלאזט	צ ע ל א ז ט
צעלאזטע	צ ע ל א ז ט ע
צעלאזן	צ ע ל א ז נ
צעלאכט	צ ע ל א כ ט
צעלאכן	צ ע ל א כ נ
צעמאלט	צ ע מ א ל ט
צעמישט	צ ע מ י ש ט
צען	צ ע נ
צען־פופצן	צ ע נ פ ו פ צ נ
צענדליג	צ ע נ ד ל י ג
צענדליגער־צענדליגער	צ ע נ ד ל י ג ע ר צ ע נ ד ל י ג ע ר
צענע־ווערענא	צ ע נ ע ו ו ע ר ע נ א
צעפ	צ ע פ
צעפאלן	צ ע פ א ל נ
צעפלאשעטע	צ ע פ ל א ש ע ט ע
צעפליקטע	צ ע פ ל י ק ט ע
צעפעלעך	צ ע פ ע ל ע כ
צעקאכט	צ ע ק א כ ט
צעקאליעטשעט	צ ע ק א ל י ע ט ש ע ט
צעקלאפן	צ ע ק ל א פ נ
צעקעמט	צ ע ק ע מ ט
צעקריגט	צ ע ק ר י ג ט
צער	צ ע ר
צער־בעלי־חיים	צ ע ר ב ע ל י ח י י מ
צערונען	צ ע ר ו נ ע נ
צערטליך	צ ע ר ט ל י כ
צערייס	צ ע ר י י ס
צערייסט	צ ע ר י י ס ט
צערייסן	צ ע ר י י ס נ
צערינט	צ ע ר י נ ט
צעריסן	צ ע ר י ס נ
צעריסענע	צ ע ר י ס ע נ ע
צעריסענעם	צ ע ר י ס ע נ ע מ
צעשיידן	צ ע ש י י ד נ
צעשלאגן	צ ע ש ל א ג נ
צעשמעטערט	צ ע ש מ ע ט ע ר ט
צעשניטן	צ ע ש נ י ט נ
צעשפאלטן	צ ע ש פ א ל ט נ
צעשפאלטענעם	צ ע ש פ א ל ט ע נ ע מ
צעשפיליעט	צ ע ש פ י ל י ע ט
צעשרייט	צ ע ש ר י י ט
צעשריען	צ ע ש ר י ע נ
צרה	צ ר ה
צרות	צ ר ו ת
קאבינעט	ק א ב י נ ע ט
קאבינעטל	ק א ב י נ ע ט ל
קאבצאנסק	ק א ב צ א נ ס ק
קאדריל	ק א ד ר י ל
קאווע	ק א ו ו ע
קאווענע	ק א ו ו ע נ ע
קאווענעס	ק א ו ו ע נ ע ס
קאוועשאנער	ק א ו ו ע ש א נ ע ר
קאזמער	ק א ז מ ע ר
קאזמערער	ק א ז מ ע ר ע ר
קאזעק	ק א ז ע ק
קאטאוועס	ק א ט א ו ו ע ס
קאטארי	ק א ט א ר י
קאטעגאר	ק א ט ע ג א ר
קאטעווען	ק א ט ע ו ו ע נ
קאטער	ק א ט ע ר
קאטערינקע	ק א ט ע ר י נ ק ע
קאטש	ק א ט ש
קאטשען	ק א ט ש ע נ
קאטשקעס	ק א ט ש ק ע ס
קאכט	ק א כ ט
קאכן	ק א כ נ
קאל	ק א ל
קאלדרע	ק א ל ד ר ע
קאלדרעס	ק א ל ד ר ע ס
קאלוזשעס	ק א ל ו ז ש ע ס
קאלט	ק א ל ט
קאלטן	ק א ל ט נ
קאלטער	ק א ל ט ע ר
קאליגע	ק א ל י ג ע
קאליר	ק א ל י ר
קאלירטע	ק א ל י ר ט ע
קאלירן	ק א ל י ר נ
קאלנער	ק א ל נ ע ר
קאלנערס	ק א ל נ ע ר ס
קאם־זיידענע	ק א מ ז י י ד ע נ ע
קאמא	ק א מ א
קאמיסיאנער	ק א מ י ס י א נ ע ר
קאמיש	ק א מ י ש
קאמעניץ	ק א מ ע נ י צ
קאמעניצער	ק א מ ע נ י צ ע ר
קאמעראד	ק א מ ע ר א ד
קאמערטאן	ק א מ ע ר ט א נ
קאמפלימענטן	ק א מ פ ל י מ ע נ ט נ
קאמפראמיס	ק א מ פ ר א מ י ס
קאן	ק א נ
קאנאפע	ק א נ א פ ע
קאנאפקע	ק א נ א פ ק ע
קאנגעלט	ק א נ ג ע ל ט
קאנגרעס־לייט	ק א נ ג ר ע ס ל י י ט
קאנווערט	ק א נ ו ו ע ר ט
קאנט	ק א נ ט
קאנטאר	ק א נ ט א ר
קאנטן	ק א נ ט נ
קאנטערבאס	ק א נ ט ע ר ב א ס
קאנטראקט	ק א נ ט ר א ק ט
קאנטראקטן	ק א נ ט ר א ק ט נ
קאנטשיק	ק א נ ט ש י ק
קאניאק	ק א נ י א ק
קאננע	ק א נ נ ע
קאנסט	ק א נ ס ט
קאנסטיטוציע	ק א נ ס ט י ט ו צ י ע
קאנסקעוואליער	ק א נ ס ק ע ו ו א ל י ע ר
קאנסקער	ק א נ ס ק ע ר
קאנען	ק א נ ע נ
קאנפערענץ	ק א נ פ ע ר ע נ צ
קאסט	ק א ס ט
קאסטן	ק א ס ט נ
קאפ	ק א פ
קאפאטע	ק א פ א ט ע
קאפאטעס	ק א פ א ט ע ס
קאפאטקעליך	ק א פ א ט ק ע ל י כ
קאפויער	ק א פ ו י ע ר
קאפטל	ק א פ ט ל
קאפטן	ק א פ ט נ
קאפטנדל	ק א פ ט נ ד ל
קאפיגע	ק א פ י ג ע
קאפיטאלן	ק א פ י ט א ל נ
קאפיטאן	ק א פ י ט א נ
קאפיטל	ק א פ י ט ל
קאפיקעס	ק א פ י ק ע ס
קאפל	ק א פ ל
קאפלעך	ק א פ ל ע כ
קאפען	ק א פ ע נ
קאפעקעס	ק א פ ע ק ע ס
קאפעשא	ק א פ ע ש א
קאפקעס	ק א פ ק ע ס
קאפריז	ק א פ ר י ז
קאץ	ק א צ
קארב	ק א ר ב
קארבן	ק א ר ב נ
קארג	ק א ר ג
קארגן	ק א ר ג נ
קארטאנע	ק א ר ט א נ ע
קארטאפל	ק א ר ט א פ ל
קארטאפליעס	ק א ר ט א פ ל י ע ס
קארטוזל	ק א ר ט ו ז ל
קארטן	ק א ר ט נ
קארידאר	ק א ר י ד א ר
קארן	ק א ר נ
קארע	ק א ר ע
קארעטן	ק א ר ע ט נ
קארפוס	ק א ר פ ו ס
קארשל	ק א ר ש ל
קארשן	ק א ר ש נ
קאשע	ק א ש ע
קאשקעטל	ק א ש ק ע ט ל
קבלת־פנים	ק ב ל ת פ נ י מ
קבצן	ק ב צ נ
קבצנים	ק ב צ נ י מ
קבצנישע	ק ב צ נ י ש ע
קבר	ק ב ר
קברים	ק ב ר י מ
קברן	ק ב ר נ
קברנס	ק ב ר נ ס
קדושה	ק ד ו ש ה
קדושעס	ק ד ו ש ע ס
קדיש	ק ד י ש
קדמון	ק ד מ ו נ
קדמונים	ק ד מ ו נ י מ
קהילה־מענטש	ק ה י ל ה מ ע נ ט ש
קהל	ק ה ל
קודלעוואטער	ק ו ד ל ע ו ו א ט ע ר
קודם	ק ו ד מ
קודם־כל	ק ו ד מ כ ל
קוואס	ק ו ו א ס
קוואס־עפעלעך	ק ו ו א ס ע פ ע ל ע כ
קוואסניג	ק ו ו א ס נ י ג
קווארס	ק ו ו א ר ס
קוויג	ק ו ו י ג
קוויגט	ק ו ו י ג ט
קוויטל	ק ו ו י ט ל
קוויטש	ק ו ו י ט ש
קוויטשעט	ק ו ו י ט ש ע ט
קוועטשט	ק ו ו ע ט ש ט
קוועטשן	ק ו ו ע ט ש נ
קוועלט	ק ו ו ע ל ט
קווערטל	ק ו ו ע ר ט ל
קווערטעלע	ק ו ו ע ר ט ע ל ע
קויל	ק ו י ל
קוילן	ק ו י ל נ
קוילעטש	ק ו י ל ע ט ש
קוילעטשן	ק ו י ל ע ט ש נ
קוילען	ק ו י ל ע נ
קוילערט	ק ו י ל ע ר ט
קוים	ק ו י מ
קוימענס	ק ו י מ ע נ ס
קוינסקעוואליע	ק ו י נ ס ק ע ו ו א ל י ע
קוינסקעוואליער	ק ו י נ ס ק ע ו ו א ל י ע ר
קוינסקער	ק ו י נ ס ק ע ר
קויס	ק ו י ס
קויע	ק ו י ע
קויף	ק ו י ף
קויפט	ק ו י פ ט
קויפן	ק ו י פ נ
קוישע־וועוירעף	ק ו י ש ע ו ו ע ו י ר ע ף
קוך	ק ו כ
קול	ק ו ל
קול־התורה	ק ו ל ה ת ו ר ה
קול־נגינה	ק ו ל נ ג י נ ה
קול־תורה	ק ו ל ת ו ר ה
קולות	ק ו ל ו ת
קולי־קולות	ק ו ל י ק ו ל ו ת
קולכל	ק ו ל כ ל
קום	ק ו מ
קומט	ק ו מ ט
קומסט	ק ו מ ס ט
קומען	ק ו מ ע נ
קונדס	ק ו נ ד ס
קונדסים	ק ו נ ד ס י מ
קונה	ק ו נ ה
קונהטעס	ק ו נ ה ט ע ס
קונים	ק ו נ י מ
קונסט	ק ו נ ס ט
קונסטטעמפל	ק ו נ ס ט ט ע מ פ ל
קונץ	ק ו נ צ
קונציג	ק ו נ צ י ג
קונציגע	ק ו נ צ י ג ע
קונצן	ק ו נ צ נ
קוסטעס	ק ו ס ט ע ס
קופאנעס	ק ו פ א נ ע ס
קופיעץ	ק ו פ י ע צ
קופער	ק ו פ ע ר
קופער־וואסער	ק ו פ ע ר ו ו א ס ע ר
קופערנע	ק ו פ ע ר נ ע
קופערנעם	ק ו פ ע ר נ ע מ
קופקע	ק ו פ ק ע
קופקעליך	ק ו פ ק ע ל י כ
קוצו־של־יוד	ק ו צ ו ש ל י ו ד
קוק	ק ו ק
קוקורעקו	ק ו ק ו ר ע ק ו
קוקט	ק ו ק ט
קוקן	ק ו ק נ
קוקנדיג	ק ו ק נ ד י ג
קוריערצוג	ק ו ר י ע ר צ ו ג
קורע־כדג	ק ו ר ע כ ד ג
קורץ	ק ו ר צ
קורצן	ק ו ר צ נ
קורצע	ק ו ר צ ע
קוש	ק ו ש
קושט	ק ו ש ט
קושן	ק ו ש נ
קושעטקע	ק ו ש ע ט ק ע
קטא	ק ט א
קי	ק י
קידאט	ק י ד א ט
קידאלטא	ק י ד א ל ט א
קידאשטא	ק י ד א ש ט א
קידאשטען	ק י ד א ש ט ע נ
קידאשטעס	ק י ד א ש ט ע ס
קידוש	ק י ד ו ש
קיטל	ק י ט ל
קיי	ק י י
קייזערליכן	ק י י ז ע ר ל י כ נ
קייט	ק י י ט
קייטן	ק י י ט נ
קייטעלעך	ק י י ט ע ל ע כ
קייכט	ק י י כ ט
קיילעכדיג	ק י י ל ע כ ד י ג
קיילעכדיגע	ק י י ל ע כ ד י ג ע
קיילעכיג	ק י י ל ע כ י ג
קיילעכיגע	ק י י ל ע כ י ג ע
קיימא־לן	ק י י מ א ל נ
קיין	ק י י נ
קיין־איין־הארע	ק י י נ א י י נ ה א ר ע
קיינמאל	ק י י נ מ א ל
קיינע	ק י י נ ע
קיינעם	ק י י נ ע מ
קיינער	ק י י נ ע ר
קייסער	ק י י ס ע ר
קייען	ק י י ע נ
קייקלען	ק י י ק ל ע נ
קיך	ק י כ
קינאה	ק י נ א ה
קינד	ק י נ ד
קינדווייז	ק י נ ד ו ו י י ז
קינדלט	ק י נ ד ל ט
קינדלען	ק י נ ד ל ע נ
קינדס	ק י נ ד ס
קינדער	ק י נ ד ע ר
קינדערלעך	ק י נ ד ע ר ל ע כ
קינדערס	ק י נ ד ע ר ס
קינות	ק י נ ו ת
קינסטלעריש	ק י נ ס ט ל ע ר י ש
קינסטלערישן	ק י נ ס ט ל ע ר י ש נ
קיסליצעס	ק י ס ל י צ ע ס
קיעוו	ק י ע ו ו
קיצור־הדבר	ק י צ ו ר ה ד ב ר
קיקא	ק י ק א
קירך	ק י ר כ
קישן	ק י ש נ
קישנס	ק י ש נ ס
קישעלע	ק י ש ע ל ע
קישעלעך	ק י ש ע ל ע כ
קלאג	ק ל א ג
קלאגט	ק ל א ג ט
קלאגן	ק ל א ג נ
קלאגעדיגע	ק ל א ג ע ד י ג ע
קלאנג	ק ל א נ ג
קלאסן	ק ל א ס נ
קלאפ	ק ל א פ
קלאפט	ק ל א פ ט
קלאפן	ק ל א פ נ
קלאפסט	ק ל א פ ס ט
קלאץ	ק ל א צ
קלאר	ק ל א ר
קלארע	ק ל א ר ע
קלארער	ק ל א ר ע ר
קלוג	ק ל ו ג
קלוגן	ק ל ו ג נ
קלוגע	ק ל ו ג ע
קלויבט	ק ל ו י ב ט
קלויז	ק ל ו י ז
קלויסטער	ק ל ו י ס ט ע ר
קלומעק	ק ל ו מ ע ק
קלומקעס	ק ל ו מ ק ע ס
קלונג	ק ל ו נ ג
קליאמקע	ק ל י א מ ק ע
קלייב	ק ל י י ב
קלייבט	ק ל י י ב ט
קלייד	ק ל י י ד
קליידל	ק ל י י ד ל
קליידליך	ק ל י י ד ל י כ
קליידער	ק ל י י ד ע ר
קליידער־אלמער	ק ל י י ד ע ר א ל מ ע ר
קליידערשאנק	ק ל י י ד ע ר ש א נ ק
קלייט	ק ל י י ט
קליין	ק ל י י נ
קליינווארג	ק ל י י נ ו ו א ר ג
קלייניגקייט	ק ל י י נ י ג ק י י ט
קליינינקע	ק ל י י נ י נ ק ע
קליינס	ק ל י י נ ס
קליינע	ק ל י י נ ע
קליינעם	ק ל י י נ ע מ
קליינער	ק ל י י נ ע ר
קליינערהייט	ק ל י י נ ע ר ה י י ט
קלינג	ק ל י נ ג
קלינגט	ק ל י נ ג ט
קלינגען	ק ל י נ ג ע נ
קלינגענדיג	ק ל י נ ג ע נ ד י ג
קלינגענדיגע	ק ל י נ ג ע נ ד י ג ע
קללות	ק ל ל ו ת
קלעטערט	ק ל ע ט ע ר ט
קלעטערן	ק ל ע ט ע ר נ
קלעם	ק ל ע מ
קלענסטן	ק ל ע נ ס ט נ
קלענערן	ק ל ע נ ע ר נ
קלענערע	ק ל ע נ ע ר ע
קלעפ	ק ל ע פ
קלעפט	ק ל ע פ ט
קלעפן	ק ל ע פ נ
קלעפעדיג	ק ל ע פ ע ד י ג
קלעצל	ק ל ע צ ל
קלעצליך	ק ל ע צ ל י כ
קלעצלען	ק ל ע צ ל ע נ
קלעצער	ק ל ע צ ע ר
קלער	ק ל ע ר
קלעשטש	ק ל ע ש ט ש
קמיעות	ק מ י ע ו ת
קנאבלבארשט	ק נ א ב ל ב א ר ש ט
קנאל	ק נ א ל
קנאפ	ק נ א פ
קנאק	ק נ א ק
קנאקט	ק נ א ק ט
קנאקן	ק נ א ק נ
קנאקניסל	ק נ א ק נ י ס ל
קני	ק נ י
קניידלעך	ק נ י י ד ל ע כ
קנייטש	ק נ י י ט ש
קנייטשט	ק נ י י ט ש ט
קנייטשן	ק נ י י ט ש נ
קנייפט	ק נ י י פ ט
קנייפן	ק נ י י פ נ
קנעבעליך	ק נ ע ב ע ל י כ
קנעט	ק נ ע ט
קנעטנדיג	ק נ ע ט נ ד י ג
קנעפ	ק נ ע פ
קנעפלט	ק נ ע פ ל ט
קנעפלעך	ק נ ע פ ל ע כ
קעאני־בעפעסעך	ק ע א נ י ב ע פ ע ס ע כ
קעגן	ק ע ג נ
קעז	ק ע ז
קעכין	ק ע כ י נ
קעלבל	ק ע ל ב ל
קעלט	ק ע ל ט
קעלנערל	ק ע ל נ ע ר ל
קעלער	ק ע ל ע ר
קען	ק ע נ
קענט	ק ע נ ט
קענטליכער	ק ע נ ט ל י כ ע ר
קעניגן	ק ע נ י ג נ
קענסט	ק ע נ ס ט
קענסטו	ק ע נ ס ט ו
קענען	ק ע נ ע נ
קענער	ק ע נ ע ר
קענערס	ק ע נ ע ר ס
קעסט	ק ע ס ט
קעסט־יונגע־לייטליך	ק ע ס ט י ו נ ג ע ל י י ט ל י כ
קעסלפויק	ק ע ס ל פ ו י ק
קעפ	ק ע פ
קעפל	ק ע פ ל
קעפמענטשן	ק ע פ מ ע נ ט ש נ
קעפן	ק ע פ נ
קעפעלעך	ק ע פ ע ל ע כ
קעצל	ק ע צ ל
קעצעלעך	ק ע צ ע ל ע כ
קער	ק ע ר
קערבל	ק ע ר ב ל
קערבלעך	ק ע ר ב ל ע כ
קערט	ק ע ר ט
קערל	ק ע ר ל
קערלעך	ק ע ר ל ע כ
קערן	ק ע ר נ
קערנדל	ק ע ר נ ד ל
קערנדלעך	ק ע ר נ ד ל ע כ
קערנער	ק ע ר נ ע ר
קערעלעך	ק ע ר ע ל ע כ
קעשענע	ק ע ש ע נ ע
קעשענעווער	ק ע ש ע נ ע ו ו ע ר
קעשענעס	ק ע ש ע נ ע ס
קצב	ק צ ב
קצבים	ק צ ב י מ
קצבישער	ק צ ב י ש ע ר
קראגנדל	ק ר א ג נ ד ל
קראכעס	ק ר א כ ע ס
קראמען	ק ר א מ ע נ
קראמפ	ק ר א מ פ
קראנק	ק ר א נ ק
קראנקן	ק ר א נ ק נ
קראנקן־אלקער	ק ר א נ ק נ א ל ק ע ר
קראנקן־חדר	ק ר א נ ק נ ח ד ר
קראנקע	ק ר א נ ק ע
קראנקער	ק ר א נ ק ע ר
קראען	ק ר א ע נ
קראפט	ק ר א פ ט
קראץ	ק ר א צ
קראצט	ק ר א צ ט
קראצן	ק ר א צ נ
קראקע	ק ר א ק ע
קראשענוויצער	ק ר א ש ע נ ו ו י צ ע ר
קרבן־מנחה	ק ר ב נ מ נ ח ה
קרובים	ק ר ו ב י מ
קרוג	ק ר ו ג
קרוטין	ק ר ו ט י נ
קרוין	ק ר ו י נ
קרום	ק ר ו מ
קרומע	ק ר ו מ ע
קרומען	ק ר ו מ ע נ
קריאת־שמע	ק ר י א ת ש מ ע
קריג	ק ר י ג
קריגט	ק ר י ג ט
קריגן	ק ר י ג נ
קריגעלע	ק ר י ג ע ל ע
קריגעלעך	ק ר י ג ע ל ע כ
קריוודע	ק ר י ו ו ד ע
קרייד	ק ר י י ד
קרייטער	ק ר י י ט ע ר
קריכט	ק ר י כ ט
קריכן	ק ר י כ נ
קרימט	ק ר י מ ט
קרימעטארטערום	ק ר י מ ע ט א ר ט ע ר ו מ
קרימען	ק ר י מ ע נ
קריסט	ק ר י ס ט
קריצט	ק ר י צ ט
קרישטאל	ק ר י ש ט א ל
קרישעלע	ק ר י ש ע ל ע
קרן	ק ר נ
קרעדיט	ק ר ע ד י ט
קרעוו	ק ר ע ו ו
קרעכץ	ק ר ע כ צ
קרעכצט	ק ר ע כ צ ט
קרעכצן	ק ר ע כ צ נ
קרעכצנדיג	ק ר ע כ צ נ ד י ג
קרעל	ק ר ע ל
קרעמער	ק ר ע מ ע ר
קרענק	ק ר ע נ ק
קרענקט	ק ר ע נ ק ט
קרענקען	ק ר ע נ ק ע נ
קרעפאסט	ק ר ע פ א ס ט
קשיא	ק ש י א
קשיות	ק ש י ו ת
ר'	ר
רא	ר א
רא־	ר א
ראבא	ר א ב א
ראביי	ר א ב י י
ראבן	ר א ב נ
ראבעטיני	ר א ב ע ט י נ י
ראבעס	ר א ב ע ס
ראד	ר א ד
ראדאמישל	ר א ד א מ י ש ל
ראובן	ר א ו ב נ
ראוז	ר א ו ז
ראוזן	ר א ו ז נ
ראוי	ר א ו י
ראזנקראנץ	ר א ז נ ק ר א נ צ
ראזעווע	ר א ז ע ו ו ע
ראזשינקע	ר א ז ש י נ ק ע
ראזשינקעס	ר א ז ש י נ ק ע ס
ראזשינקעס־וויין	ר א ז ש י נ ק ע ס ו ו י י נ
ראטעוועט	ר א ט ע ו ו ע ט
ראטעווען	ר א ט ע ו ו ע נ
ראיה	ר א י ה
ראלע	ר א ל ע
ראם־באם	ר א מ ב א מ
ראמאנען	ר א מ א נ ע נ
ראנד	ר א נ ד
ראנדל	ר א נ ד ל
ראספוטין	ר א ס פ ו ט י נ
ראספוטינען	ר א ס פ ו ט י נ ע נ
ראק	ר א ק
ראש־האמעדבארים	ר א ש ה א מ ע ד ב א ר י מ
ראש־השנה	ר א ש ה ש נ ה
ראש־חודש	ר א ש ח ו ד ש
ראש־חודש־רעטעכליך	ר א ש ח ו ד ש ר ע ט ע כ ל י כ
ראשעדיג	ר א ש ע ד י ג
רב	ר ב
רבונו־של־עולם	ר ב ו נ ו ש ל ע ו ל מ
רבותי	ר ב ו ת י
רבותים	ר ב ו ת י מ
רבי	ר ב י
רבין	ר ב י נ
רבינס	ר ב י נ ס
רביס	ר ב י ס
רביצין	ר ב י צ י נ
רביצינס	ר ב י צ י נ ס
רבנו	ר ב נ ו
רבנים	ר ב נ י מ
רבנן־קדיש	ר ב נ נ ק ד י ש
רבס	ר ב ס
רגילות	ר ג י ל ו ת
רגל	ר ג ל
רגלים	ר ג ל י מ
רגע	ר ג ע
רו	ר ו
רואיג	ר ו א י ג
רואיגן	ר ו א י ג נ
רואיגע	ר ו א י ג ע
רואיגקייט	ר ו א י ג ק י י ט
רובל	ר ו ב ל
רובלדיגן	ר ו ב ל ד י ג נ
רוגזה	ר ו ג ז ה
רודער	ר ו ד ע ר
רודערן	ר ו ד ע ר נ
רווחים	ר ו ו ח י מ
רוח	ר ו ח
רוחות	ר ו ח ו ת
רוט	ר ו ט
רויז	ר ו י ז
רויזיגע	ר ו י ז י ג ע
רויט	ר ו י ט
רויט־ברענענדיגע	ר ו י ט ב ר ע נ ע נ ד י ג ע
רויטבלויען	ר ו י ט ב ל ו י ע נ
רויטהאריגע	ר ו י ט ה א ר י ג ע
רויטינקע	ר ו י ט י נ ק ע
רויטלט	ר ו י ט ל ט
רויטליכע	ר ו י ט ל י כ ע
רויטליכער	ר ו י ט ל י כ ע ר
רויטליכקייט	ר ו י ט ל י כ ק י י ט
רויטן	ר ו י ט נ
רויטע	ר ו י ט ע
רויטער	ר ו י ט ע ר
רויטשילד	ר ו י ט ש י ל ד
רויטשילדס	ר ו י ט ש י ל ד ס
רויך	ר ו י כ
רויכיגע	ר ו י כ י ג ע
רויכער	ר ו י כ ע ר
רויכערט	ר ו י כ ע ר ט
רויכערן	ר ו י כ ע ר נ
רוימט	ר ו י מ ט
רוישט	ר ו י ש ט
רוכאניעס	ר ו כ א נ י ע ס
רונדיג	ר ו נ ד י ג
רונדיגע	ר ו נ ד י ג ע
רונדן	ר ו נ ד נ
רוסיש	ר ו ס י ש
רוסישע	ר ו ס י ש ע
רוען	ר ו ע נ
רוף	ר ו ף
רופא	ר ו פ א
רופאטע	ר ו פ א ט ע
רופאטעס	ר ו פ א ט ע ס
רופאס	ר ו פ א ס
רופט	ר ו פ ט
רופן	ר ו פ נ
רוצח	ר ו צ ח
רוצחים	ר ו צ ח י מ
רוק	ר ו ק
רוקט	ר ו ק ט
רוקן	ר ו ק נ
רוקנס	ר ו ק נ ס
רחבותדיגקייט	ר ח ב ו ת ד י ג ק י י ט
רחל־לאה	ר ח ל ל א ה
רחמים	ר ח מ י מ
רחמנא־לצלן	ר ח מ נ א ל צ ל נ
רחמנות	ר ח מ נ ו ת
ריגאשי	ר י ג א ש י
ריזיג	ר י ז י ג
ריזיגן	ר י ז י ג נ
ריזן	ר י ז נ
ריח	ר י ח
ריחות	ר י ח ו ת
ריטליך	ר י ט ל י כ
ריטשן	ר י ט ש נ
רייבט	ר י י ב ט
רייבן	ר י י ב נ
רייבעניש	ר י י ב ע נ י ש
רייד	ר י י ד
ריידן	ר י י ד נ
ריידנדיג	ר י י ד נ ד י ג
רייזען	ר י י ז ע נ
רייך	ר י י כ
רייכן	ר י י כ נ
רייכע	ר י י כ ע
רייכער	ר י י כ ע ר
רייכערן	ר י י כ ע ר נ
ריין	ר י י נ
ריינע	ר י י נ ע
ריינעם	ר י י נ ע מ
רייס	ר י י ס
רייסט	ר י י ס ט
רייסן	ר י י ס נ
רייען	ר י י ע נ
רייף	ר י י ף
רייצט	ר י י צ ט
רייצן	ר י י צ נ
ריכטיגן	ר י כ ט י ג נ
ריכטיגע	ר י כ ט י ג ע
ריכטן	ר י כ ט נ
רינגלט	ר י נ ג ל ט
רינגלען	ר י נ ג ל ע נ
רינד	ר י נ ד
רינט	ר י נ ט
רינע	ר י נ ע
רינען	ר י נ ע נ
ריס	ר י ס
ריפ־סקריפ	ר י פ ס ק ר י פ
ריר	ר י ר
רירט	ר י ר ט
רירן	ר י ר נ
ריש	ר י ש
רמבם	ר מ ב מ
רעאביליטירן	ר ע א ב י ל י ט י ר נ
רעאליזם	ר ע א ל י ז מ
רעגן	ר ע ג נ
רעד	ר ע ד
רעדט	ר ע ד ט
רעדל	ר ע ד ל
רעדלט	ר ע ד ל ט
רעדלעך	ר ע ד ל ע כ
רעדן	ר ע ד נ
רעדנדיג	ר ע ד נ ד י ג
רעדסטו	ר ע ד ס ט ו
רעדער	ר ע ד ע ר
רעוואלוציע	ר ע ו ו א ל ו צ י ע
רעוואלוציעס	ר ע ו ו א ל ו צ י ע ס
רעזשיסאר	ר ע ז ש י ס א ר
רעטאריק	ר ע ט א ר י ק
רעטעכער	ר ע ט ע כ ע ר
רעין	ר ע י נ
רעכט	ר ע כ ט
רעכטן	ר ע כ ט נ
רעכטס	ר ע כ ט ס
רעכטע	ר ע כ ט ע
רעכטער	ר ע כ ט ע ר
רעכן	ר ע כ נ
רעכן־מייסטער	ר ע כ נ מ י י ס ט ע ר
רעכן־מייסטערס	ר ע כ נ מ י י ס ט ע ר ס
רעכנט	ר ע כ נ ט
רעכענונג	ר ע כ ע נ ו נ ג
רעכענונגען	ר ע כ ע נ ו נ ג ע נ
רעכענען	ר ע כ ע נ ע נ
רעפובליקאנישע	ר ע פ ו ב ל י ק א נ י ש ע
רעצעפט	ר ע צ ע פ ט
רעצעפטן	ר ע צ ע פ ט נ
רעקל	ר ע ק ל
רעש	ר ע ש
רעש'ן	ר ע ש נ
רעשטל	ר ע ש ט ל
רפואה	ר פ ו א ה
רפואות	ר פ ו א ו ת
רצון	ר צ ו נ
רציחהדיג	ר צ י ח ה ד י ג
רשות	ר ש ו ת
רשות־הרבים	ר ש ו ת ה ר ב י מ
רשי	ר ש י
רשעטע	ר ש ע ט ע
רשעים	ר ש ע י מ
שא	ש א
שאבעס	ש א ב ע ס
שאד	ש א ד
שאדט	ש א ד ט
שאדן	ש א ד נ
שאט	ש א ט
שאט־שאט	ש א ט ש א ט
שאטן	ש א ט נ
שאטנס	ש א ט נ ס
שאך	ש א כ
שאכאני	ש א כ א נ י
שאכלינער	ש א כ ל י נ ע ר
שאל	ש א ל
שאלה	ש א ל ה
שאלן	ש א ל נ
שאלעכץ	ש א ל ע כ צ
שאלעמויזן	ש א ל ע מ ו י ז נ
שאלקאוויצעס	ש א ל ק א ו ו י צ ע ס
שאנק	ש א נ ק
שאפן	ש א פ נ
שאפן־פעלצן	ש א פ נ פ ע ל צ נ
שאפנפעלץ	ש א פ נ פ ע ל צ
שאפע	ש א פ ע
שאפענע	ש א פ ע נ ע
שאק	ש א ק
שאקאלאד־קאליר	ש א ק א ל א ד ק א ל י ר
שאקל	ש א ק ל
שאקלט	ש א ק ל ט
שאקלען	ש א ק ל ע נ
שאר	ש א ר
שארט	ש א ר ט
שארן	ש א ר נ
שארנדיגע	ש א ר נ ד י ג ע
שארף	ש א ר ף
שארפן	ש א ר פ נ
שארפע	ש א ר פ ע
שארפער	ש א ר פ ע ר
שבועה־דאורייתא	ש ב ו ע ה ד א ו ר י י ת א
שבועות	ש ב ו ע ו ת
שבח	ש ב ח
שבט	ש ב ט
שבעולם	ש ב ע ו ל מ
שבת	ש ב ת
שבת'דיג	ש ב ת ד י ג
שבת'דיגע	ש ב ת ד י ג ע
שבת־הגדול	ש ב ת ה ג ד ו ל
שבת־לאבוסעס	ש ב ת ל א ב ו ס ע ס
שבת־מלכה־חן	ש ב ת מ ל כ ה ח נ
שבת־נחמו	ש ב ת נ ח מ ו
שבתים	ש ב ת י מ
שדים	ש ד י מ
שדכן	ש ד כ נ
שהחיינו	ש ה ח י י נ ו
שו־	ש ו
שואוואקס	ש ו א ו ו א ק ס
שוואגער	ש ו ו א ג ע ר
שוואגערס	ש ו ו א ג ע ר ס
שוואך	ש ו ו א כ
שוואכער	ש ו ו א כ ע ר
שווארץ	ש ו ו א ר צ
שווארצט	ש ו ו א ר צ ט
שווארצן	ש ו ו א ר צ נ
שווארצס	ש ו ו א ר צ ס
שווארצע	ש ו ו א ר צ ע
שווארצער	ש ו ו א ר צ ע ר
שוויגער	ש ו ו י ג ע ר
שוויגערס	ש ו ו י ג ע ר ס
שווייג	ש ו ו י י ג
שווייגט	ש ו ו י י ג ט
שווייגן	ש ו ו י י ג נ
שווייגנדיג	ש ו ו י י ג נ ד י ג
שווייגס	ש ו ו י י ג ס
שווייס	ש ו ו י י ס
שווים	ש ו ו י מ
שווימט	ש ו ו י מ ט
שווימען	ש ו ו י מ ע נ
שווינדלענדיגער	ש ו ו י נ ד ל ע נ ד י ג ע ר
שווינדלער	ש ו ו י נ ד ל ע ר
שוויצט	ש ו ו י צ ט
שוויצן	ש ו ו י צ נ
שוועבל	ש ו ו ע ב ל
שוועבן	ש ו ו ע ב נ
שוועגערין	ש ו ו ע ג ע ר י נ
שוועל	ש ו ו ע ל
שוועלן	ש ו ו ע ל נ
שוועמליך	ש ו ו ע מ ל י כ
שוועסטער	ש ו ו ע ס ט ע ר
שוועסטערל	ש ו ו ע ס ט ע ר ל
שוועסטערליך	ש ו ו ע ס ט ע ר ל י כ
שוועסטערקינד	ש ו ו ע ס ט ע ר ק י נ ד
שוועסטערקינדער	ש ו ו ע ס ט ע ר ק י נ ד ע ר
שווער	ש ו ו ע ר
שווערדן	ש ו ו ע ר ד נ
שווערט	ש ו ו ע ר ט
שווערינקע	ש ו ו ע ר י נ ק ע
שווערליך	ש ו ו ע ר ל י כ
שווערן	ש ו ו ע ר נ
שווערסטע	ש ו ו ע ר ס ט ע
שווערסטער	ש ו ו ע ר ס ט ע ר
שווערע	ש ו ו ע ר ע
שווערער	ש ו ו ע ר ע ר
שווערערס	ש ו ו ע ר ע ר ס
שוחט	ש ו ח ט
שוחט'ס	ש ו ח ט ס
שוחט'קע	ש ו ח ט ק ע
שויב	ש ו י ב
שויבן	ש ו י ב נ
שויבן־שענקל	ש ו י ב נ ש ע נ ק ל
שוים	ש ו י מ
שוין	ש ו י נ
שויס	ש ו י ס
שול	ש ו ל
שולגעסל	ש ו ל ג ע ס ל
שולדיג	ש ו ל ד י ג
שולחן־ערוך	ש ו ל ח נ ע ר ו כ
שולן	ש ו ל נ
שום	ש ו מ
שומר־ווע־מציל	ש ו מ ר ו ו ע מ צ י ל
שומר־ומציל	ש ו מ ר ו מ צ י ל
שונא	ש ו נ א
שונא'טע	ש ו נ א ט ע
שונא־ישראל	ש ו נ א י ש ר א ל
שונאים	ש ו נ א י מ
שונד	ש ו נ ד
שוסטער	ש ו ס ט ע ר
שוסטערס	ש ו ס ט ע ר ס
שופלאדל	ש ו פ ל א ד ל
שופר	ש ו פ ר
שוץ	ש ו צ
שורש	ש ו ר ש
שושנת־יעקב	ש ו ש נ ת י ע ק ב
שותף	ש ו ת ף
שותפות	ש ו ת פ ו ת
שותפים	ש ו ת פ י מ
שטאט	ש ט א ט
שטאט־באלעבאטים	ש ט א ט ב א ל ע ב א ט י מ
שטאט־בעל־הבית	ש ט א ט ב ע ל ה ב י ת
שטאט־בעל־הבית'טע	ש ט א ט ב ע ל ה ב י ת ט ע
שטאט־רב	ש ט א ט ר ב
שטאטבערזע	ש ט א ט ב ע ר ז ע
שטאטגלאק	ש ט א ט ג ל א ק
שטאטגעסל	ש ט א ט ג ע ס ל
שטאטישע	ש ט א ט י ש ע
שטאטס	ש ט א ט ס
שטאטשטוב	ש ט א ט ש ט ו ב
שטאך	ש ט א כ
שטאל	ש ט א ל
שטאלט	ש ט א ל ט
שטאלן	ש ט א ל נ
שטאלץ	ש ט א ל צ
שטאנד	ש ט א נ ד
שטאפן	ש ט א פ נ
שטארב	ש ט א ר ב
שטארבן	ש ט א ר ב נ
שטארט	ש ט א ר ט
שטארצן	ש ט א ר צ נ
שטארק	ש ט א ר ק
שטארקן	ש ט א ר ק נ
שטארקע	ש ט א ר ק ע
שטארקער	ש ט א ר ק ע ר
שטוב	ש ט ו ב
שטוב־ווארעמקייט	ש ט ו ב ו ו א ר ע מ ק י י ט
שטובזאכן	ש ט ו ב ז א כ נ
שטובמענטשן	ש ט ו ב מ ע נ ט ש נ
שטודירן	ש ט ו ד י ר נ
שטויב	ש ט ו י ב
שטויבעלע	ש ט ו י ב ע ל ע
שטויסל	ש ט ו י ס ל
שטויסן	ש ט ו י ס נ
שטול	ש ט ו ל
שטולן	ש ט ו ל נ
שטום	ש ט ו מ
שטומע	ש ט ו מ ע
שטומען	ש ט ו מ ע נ
שטומער	ש ט ו מ ע ר
שטומפיג	ש ט ו מ פ י ג
שטופ	ש ט ו פ
שטופט	ש ט ו פ ט
שטופן	ש ט ו פ נ
שטורקאצן	ש ט ו ר ק א צ נ
שטיבל	ש ט י ב ל
שטיבער	ש ט י ב ע ר
שטיגן	ש ט י ג נ
שטיוול	ש ט י ו ו ל
שטיוולעטן	ש ט י ו ו ל ע ט נ
שטיוועלעך	ש ט י ו ו ע ל ע כ
שטיי	ש ט י י
שטייגן	ש ט י י ג נ
שטייגער	ש ט י י ג ע ר
שטייט	ש ט י י ט
שטיין	ש ט י י נ
שטיינער	ש ט י י נ ע ר
שטייען	ש ט י י ע נ
שטייענדיג	ש ט י י ע נ ד י ג
שטייענדיגע	ש ט י י ע נ ד י ג ע
שטייף	ש ט י י ף
שטיל	ש ט י ל
שטיל־פארטרונקענער	ש ט י ל פ א ר ט ר ו נ ק ע נ ע ר
שטיל־שווייגנדיג	ש ט י ל ש ו ו י י ג נ ד י ג
שטילן	ש ט י ל נ
שטילע	ש ט י ל ע
שטילעניש	ש ט י ל ע נ י ש
שטילער	ש ט י ל ע ר
שטילערהייט	ש ט י ל ע ר ה י י ט
שטילשווייגן	ש ט י ל ש ו ו י י ג נ
שטילשווייגנדיג	ש ט י ל ש ו ו י י ג נ ד י ג
שטילשווייגעניש	ש ט י ל ש ו ו י י ג ע נ י ש
שטים	ש ט י מ
שטימט	ש ט י מ ט
שטימע	ש ט י מ ע
שטימען	ש ט י מ ע נ
שטיפמאמע	ש ט י פ מ א מ ע
שטיק	ש ט י ק
שטיקל	ש ט י ק ל
שטיקלעך	ש ט י ק ל ע כ
שטיקלעכווייז	ש ט י ק ל ע כ ו ו י י ז
שטיקן	ש ט י ק נ
שטיקער	ש ט י ק ע ר
שטן	ש ט נ
שטעגעליך	ש ט ע ג ע ל י כ
שטעט	ש ט ע ט
שטעטל	ש ט ע ט ל
שטעכווערטער	ש ט ע כ ו ו ע ר ט ע ר
שטעכט	ש ט ע כ ט
שטעכלדיגע	ש ט ע כ ל ד י ג ע
שטעכלקעס	ש ט ע כ ל ק ע ס
שטעכן	ש ט ע כ נ
שטעכנדיג	ש ט ע כ נ ד י ג
שטעכעלקעס	ש ט ע כ ע ל ק ע ס
שטעכעניש	ש ט ע כ ע נ י ש
שטעל	ש ט ע ל
שטעלט	ש ט ע ל ט
שטעלן	ש ט ע ל נ
שטעלע	ש ט ע ל ע
שטעלעכל	ש ט ע ל ע כ ל
שטענדיג	ש ט ע נ ד י ג
שטענדער	ש ט ע נ ד ע ר
שטעק	ש ט ע ק
שטעקט	ש ט ע ק ט
שטעקל	ש ט ע ק ל
שטעקן	ש ט ע ק נ
שטעקנס	ש ט ע ק נ ס
שטעקשיך	ש ט ע ק ש י כ
שטערט	ש ט ע ר ט
שטערן	ש ט ע ר נ
שטערן־טיכלעך	ש ט ע ר נ ט י כ ל ע כ
שטערנס	ש ט ע ר נ ס
שטראל	ש ט ר א ל
שטראלן	ש ט ר א ל נ
שטראם	ש ט ר א מ
שטראמט	ש ט ר א מ ט
שטראמיג	ש ט ר א מ י ג
שטראמען	ש ט ר א מ ע נ
שטראמענדיג	ש ט ר א מ ע נ ד י ג
שטראף	ש ט ר א ף
שטראפן	ש ט ר א פ נ
שטרודלען	ש ט ר ו ד ל ע נ
שטרוי	ש ט ר ו י
שטריימל	ש ט ר י י מ ל
שטריק	ש ט ר י ק
שטריקאוועס	ש ט ר י ק א ו ו ע ס
שטריקל	ש ט ר י ק ל
שטריקן	ש ט ר י ק נ
שטריקנאדלען	ש ט ר י ק נ א ד ל ע נ
שטרענג	ש ט ר ע נ ג
שטרעק	ש ט ר ע ק
שטרעקט	ש ט ר ע ק ט
שידוך	ש י ד ו כ
שידוכים	ש י ד ו כ י מ
שיט	ש י ט
שיטן	ש י ט נ
שיטער	ש י ט ע ר
שיטערע	ש י ט ע ר ע
שיטערער	ש י ט ע ר ע ר
שייגעץ	ש י י ג ע צ
שייד	ש י י ד
שיידט	ש י י ד ט
שייטל	ש י י ט ל
שייטלעך	ש י י ט ל ע כ
שייטלען	ש י י ט ל ע נ
שייך	ש י י כ
שייכות	ש י י כ ו ת
שיילט	ש י י ל ט
שיין	ש י י נ
שיינט	ש י י נ ט
שיינס	ש י י נ ס
שיינע	ש י י נ ע
שיינעם	ש י י נ ע מ
שיינענדיגער	ש י י נ ע נ ד י ג ע ר
שיינער	ש י י נ ע ר
שיך	ש י כ
שיכור	ש י כ ו ר
שיכורים	ש י כ ו ר י מ
שיכורערהייט	ש י כ ו ר ע ר ה י י ט
שילד	ש י ל ד
שילדער	ש י ל ד ע ר
שילטן	ש י ל ט נ
שימו	ש י מ ו
שימכעם	ש י מ כ ע מ
שימל	ש י מ ל
שימערט	ש י מ ע ר ט
שין	ש י נ
שינאה	ש י נ א ה
שיסט	ש י ס ט
שיסל	ש י ס ל
שיעור	ש י ע ו ר
שיעס	ש י ע ס
שיער	ש י ע ר
שיף	ש י ף
שיפל	ש י פ ל
שיצט	ש י צ ט
שיקט	ש י ק ט
שיקן	ש י ק נ
שיר	ש י ר
שיר־השירים	ש י ר ה ש י ר י מ
שיריים	ש י ר י י מ
שירץ	ש י ר צ
שירצליך	ש י ר צ ל י כ
שירצן	ש י ר צ נ
שישים	ש י ש י מ
שישיס־יאמי־בראשית	ש י ש י ס י א מ י ב ר א ש י ת
שישקעס	ש י ש ק ע ס
שכינה	ש כ י נ ה
שכירות	ש כ י ר ו ת
שכל	ש כ ל
שכן	ש כ נ
שכן'ס	ש כ נ ס
שכנה	ש כ נ ה
שכנה'ס	ש כ נ ה ס
של	ש ל
שלאגט	ש ל א ג ט
שלאגן	ש ל א ג נ
שלאגסטו	ש ל א ג ס ט ו
שלאכטפעלד	ש ל א כ ט פ ע ל ד
שלאנג	ש ל א נ ג
שלאנגען	ש ל א נ ג ע נ
שלאנק	ש ל א נ ק
שלאף	ש ל א ף
שלאפט	ש ל א פ ט
שלאפן	ש ל א פ נ
שלאפקייט	ש ל א פ ק י י ט
שלאפקייטן	ש ל א פ ק י י ט נ
שלאפראק	ש ל א פ ר א ק
שלום	ש ל ו מ
שלום־ושלווה	ש ל ו מ ו ש ל ו ו ה
שלום־עליכם	ש ל ו מ ע ל י כ מ
שלי'מזל	ש ל י מ ז ל
שליח־ציבור	ש ל י ח צ י ב ו ר
שליחות	ש ל י ח ו ת
שליטן	ש ל י ט נ
שלייער	ש ל י י ע ר
שלייערס	ש ל י י ע ר ס
שלייפן	ש ל י י פ נ
שלים־שלי'מזל	ש ל י מ ש ל י מ ז ל
שלינג	ש ל י נ ג
שלינגט	ש ל י נ ג ט
שלינגען	ש ל י נ ג ע נ
שליסל	ש ל י ס ל
שליסלעך	ש ל י ס ל ע כ
שלמה	ש ל מ ה
שלעכט	ש ל ע כ ט
שלעכטס	ש ל ע כ ט ס
שלעכטע	ש ל ע כ ט ע
שלעכטער	ש ל ע כ ט ע ר
שלעפט	ש ל ע פ ט
שלעפן	ש ל ע פ נ
שלעפנדיג	ש ל ע פ נ ד י ג
שלעק	ש ל ע ק
שם	ש מ
שמאטע	ש מ א ט ע
שמאטעס	ש מ א ט ע ס
שמאל	ש מ א ל
שמאלע	ש מ א ל ע
שמאלץ	ש מ א ל צ
שמאלצגרוב	ש מ א ל צ ג ר ו ב
שמויגער	ש מ ו י ג ע ר
שמונה־ע'שרה	ש מ ו נ ה ע ש ר ה
שמועס	ש מ ו ע ס
שמועסט	ש מ ו ע ס ט
שמועסן	ש מ ו ע ס נ
שמועסנדיג	ש מ ו ע ס נ ד י ג
שמות	ש מ ו ת
שמחה	ש מ ח ה
שמחות	ש מ ח ו ת
שמחת־תורה	ש מ ח ת ת ו ר ה
שמיי	ש מ י י
שמיי־ראבא	ש מ י י ר א ב א
שמייכל	ש מ י י כ ל
שמייכלט	ש מ י י כ ל ט
שמייכלענדיגע	ש מ י י כ ל ע נ ד י ג ע
שמייכעלע	ש מ י י כ ע ל ע
שמייסט	ש מ י י ס ט
שמייסן	ש מ י י ס נ
שמייסער	ש מ י י ס ע ר
שמיץ	ש מ י צ
שמיר־מיט־פוטער	ש מ י ר מ י ט פ ו ט ע ר
שמירט	ש מ י ר ט
שמע־ישראל	ש מ ע י ש ר א ל
שמעמעס	ש מ ע מ ע ס
שמעק	ש מ ע ק
שמעקט	ש מ ע ק ט
שמעקן	ש מ ע ק נ
שמעקנדיג	ש מ ע ק נ ד י ג
שמעקנדיגע	ש מ ע ק נ ד י ג ע
שמעקעדיגע	ש מ ע ק ע ד י ג ע
שמש	ש מ ש
שנארכן	ש נ א ר כ נ
שנויצן	ש נ ו י צ נ
שנופטיכלעך	ש נ ו פ ט י כ ל ע כ
שנור	ש נ ו ר
שנורס	ש נ ו ר ס
שניטרעק	ש נ י ט ר ע ק
שניי	ש נ י י
שניי־בוימעלעך	ש נ י י ב ו י מ ע ל ע כ
שנייד	ש נ י י ד
שניידט	ש נ י י ד ט
שניידן	ש נ י י ד נ
שניידעק	ש נ י י ד ע ק
שניידער	ש נ י י ד ע ר
שניידעריונג	ש נ י י ד ע ר י ו נ ג
שניידערין	ש נ י י ד ע ר י נ
שניידערישע	ש נ י י ד ע ר י ש ע
שניידערישער	ש נ י י ד ע ר י ש ע ר
שניידערס	ש נ י י ד ע ר ס
שנייוועלט	ש נ י י ו ו ע ל ט
שנייענדיגער	ש נ י י ע נ ד י ג ע ר
שניפס	ש נ י פ ס
שניפסל	ש נ י פ ס ל
שניר	ש נ י ר
שנעל	ש נ ע ל
שנעלט	ש נ ע ל ט
שס	ש ס
שעבע	ש ע ב ע
שעבעבלאטע	ש ע ב ע ב ל א ט ע
שעבעשמאטע	ש ע ב ע ש מ א ט ע
שעה	ש ע ה
שעלט	ש ע ל ט
שעלמיש	ש ע ל מ י ש
שעם	ש ע מ
שעמט	ש ע מ ט
שעמען	ש ע מ ע נ
שעמעניץ	ש ע מ ע נ י צ
שעמעניצער	ש ע מ ע נ י צ ע ר
שענסטע	ש ע נ ס ט ע
שענער	ש ע נ ע ר
שענק	ש ע נ ק
שענקען	ש ע נ ק ע נ
שעפס	ש ע פ ס
שעפסן	ש ע פ ס נ
שעפער	ש ע פ ע ר
שערענגע	ש ע ר ע נ ג ע
שערעצקע	ש ע ר ע צ ק ע
שפאגל־נייע	ש פ א ג ל נ י י ע
שפאלט	ש פ א ל ט
שפאלטן	ש פ א ל ט נ
שפאלע	ש פ א ל ע
שפאניען	ש פ א נ י ע נ
שפאנען	ש פ א נ ע נ
שפאנקעס	ש פ א נ ק ע ס
שפאס	ש פ א ס
שפאצירט	ש פ א צ י ר ט
שפאצירן	ש פ א צ י ר נ
שפאקטיוול	ש פ א ק ט י ו ו ל
שפאר	ש פ א ר
שפארן	ש פ א ר נ
שפארעוודיגער	ש פ א ר ע ו ו ד י ג ע ר
שפורן	ש פ ו ר נ
שפיגלט	ש פ י ג ל ט
שפיטאל	ש פ י ט א ל
שפיטאלבעט	ש פ י ט א ל ב ע ט
שפיי	ש פ י י
שפייט	ש פ י י ט
שפייכלער	ש פ י י כ ל ע ר
שפייען	ש פ י י ע נ
שפיכת־דמים	ש פ י כ ת ד מ י מ
שפיל	ש פ י ל
שפילט	ש פ י ל ט
שפילכל	ש פ י ל כ ל
שפילן	ש פ י ל נ
שפילסט	ש פ י ל ס ט
שפילקע	ש פ י ל ק ע
שפילשליווער	ש פ י ל ש ל י ו ו ע ר
שפינוועבס	ש פ י נ ו ו ע ב ס
שפיץ	ש פ י צ
שפיצל	ש פ י צ ל
שפיצן	ש פ י צ נ
שפיצעכיגע	ש פ י צ ע כ י ג ע
שפע	ש פ ע
שפעט	ש פ ע ט
שפעטער	ש פ ע ט ע ר
שפענדלעך	ש פ ע נ ד ל ע כ
שפראצט	ש פ ר א צ ט
שפראצן	ש פ ר א צ נ
שפראצנדיגע	ש פ ר א צ נ ד י ג ע
שפראצעכץ	ש פ ר א צ ע כ צ
שפרוך	ש פ ר ו כ
שפרונג	ש פ ר ו נ ג
שפרייט	ש פ ר י י ט
שפרינג	ש פ ר י נ ג
שפרינגט	ש פ ר י נ ג ט
שפרינגען	ש פ ר י נ ג ע נ
שפרינזינעס	ש פ ר י נ ז י נ ע ס
שפריצט	ש פ ר י צ ט
שקצים	ש ק צ י מ
שקר־וכזב	ש ק ר ו כ ז ב
שראנק	ש ר א נ ק
שראנקען	ש ר א נ ק ע נ
שרייב	ש ר י י ב
שרייבט	ש ר י י ב ט
שרייבטיש	ש ר י י ב ט י ש
שרייבן	ש ר י י ב נ
שרייבער	ש ר י י ב ע ר
שרייבערל	ש ר י י ב ע ר ל
שרייט	ש ר י י ט
שרייען	ש ר י י ע נ
שריפטן	ש ר י פ ט נ
שרעק	ש ר ע ק
שרעקט	ש ר ע ק ט
שרעקלעך	ש ר ע ק ל ע כ
שרעקן	ש ר ע ק נ
שרפה	ש ר פ ה
שררות	ש ר ר ו ת
ששת־ימי־בראשית	ש ש ת י מ י ב ר א ש י ת
תאווה	ת א ו ו ה
תבואה	ת ב ו א ה
תהילים	ת ה י ל י מ
תהילים־זאגן	ת ה י ל י מ ז א ג נ
תוך	ת ו כ
תוך־כדי־דיבור	ת ו כ כ ד י ד י ב ו ר
תופס	ת ו פ ס
תורה	ת ו ר ה
תושב	ת ו ש ב
תחום־שבת	ת ח ו מ ש ב ת
תחילת	ת ח י ל ת
תחית־המתים	ת ח י ת ה מ ת י מ
תחנונים	ת ח נ ו נ י מ
תחתונימליך	ת ח ת ו נ י מ ל י כ
תיכף	ת י כ ף
תיקון	ת י ק ו נ
תירוץ	ת י ר ו צ
תירוצים	ת י ר ו צ י מ
תישעה	ת י ש ע ה
תכלית	ת כ ל י ת
תכריכים	ת כ ר י כ י מ
תכשיט	ת כ ש י ט
תל	ת ל
תלמוד־תורה	ת ל מ ו ד ת ו ר ה
תמוז	ת מ ו ז
תמיד	ת מ י ד
תמעוואטע	ת מ ע ו ו א ט ע
תנאי	ת נ א י
תנאים	ת נ א י מ
תנך	ת נ כ
תעניתים	ת ע נ י ת י מ
תפילה	ת פ י ל ה
תפילין	ת פ י ל י נ
תפילין־בייטעלע	ת פ י ל י נ ב י י ט ע ל ע
תפיסה	ת פ י ס ה
תרעומות	ת ר ע ו מ ו ת
תשבורת	ת ש ב ו ר ת
תשובה	ת ש ו ב ה
